Up/Down,Upgrade,Same,Downgrade,Defaulted,Non-Rated,Totals
01/31/1981,0,217,8,0,1,226
02/28/1981,0,220,7,0,0,227
03/31/1981,2,223,4,0,1,230
04/30/1981,4,220,4,0,2,230
05/31/1981,0,230,0,0,1,231
06/30/1981,3,224,3,0,0,230
07/31/1981,1,227,2,0,1,231
08/31/1981,0,229,2,0,0,231
09/30/1981,1,231,1,0,1,234
10/31/1981,1,232,2,0,0,235
11/30/1981,0,236,0,0,0,236
12/31/1981,0,234,2,0,0,236
01/31/1982,2,236,1,1,0,240
02/28/1982,0,237,0,1,1,239
03/31/1982,0,233,2,0,2,237
04/30/1982,0,231,1,2,2,236
05/31/1982,0,230,2,0,0,232
06/30/1982,1,229,1,0,1,232
07/31/1982,0,228,3,0,1,232
08/31/1982,0,230,1,0,1,232
09/30/1982,0,230,1,0,0,231
10/31/1982,1,229,3,0,0,233
11/30/1982,1,231,3,0,3,238
12/31/1982,1,232,0,0,7,240
01/31/1983,1,229,4,0,4,238
02/28/1983,0,236,0,0,0,236
03/31/1983,0,233,2,0,1,236
04/30/1983,2,233,2,2,2,241
05/31/1983,2,236,0,0,0,238
06/30/1983,0,234,2,0,3,239
07/31/1983,1,235,0,1,0,237
08/31/1983,1,233,1,0,2,237
09/30/1983,1,235,2,0,0,238
10/31/1983,1,236,0,0,1,238
11/30/1983,1,235,0,0,2,238
12/31/1983,1,234,1,0,1,237
01/31/1984,0,239,0,0,1,240
02/29/1984,0,242,1,0,0,243
03/31/1984,1,239,1,1,1,243
04/30/1984,2,237,1,0,2,242
05/31/1984,1,239,0,0,1,241
06/30/1984,4,233,2,0,3,242
07/31/1984,2,239,0,0,1,242
08/31/1984,0,239,2,0,0,241
09/30/1984,0,243,0,0,2,245
10/31/1984,2,245,0,0,1,248
11/30/1984,0,251,1,0,1,253
12/31/1984,1,248,3,0,2,254
01/31/1985,0,245,4,0,6,255
02/28/1985,0,255,1,1,0,257
03/31/1985,0,256,0,1,0,257
04/30/1985,0,261,0,0,2,263
05/31/1985,0,263,0,0,1,264
06/30/1985,3,258,6,0,2,269
07/31/1985,0,268,4,0,1,273
08/31/1985,1,274,2,0,0,277
09/30/1985,0,280,0,0,0,280
10/31/1985,1,274,6,1,1,283
11/30/1985,0,282,2,0,3,287
12/31/1985,2,283,1,0,0,286
01/31/1986,0,278,3,0,8,289
02/28/1986,0,279,2,0,1,282
03/31/1986,0,275,6,1,0,282
04/30/1986,1,282,0,0,2,285
05/31/1986,0,280,4,0,2,286
06/30/1986,3,279,0,0,5,287
07/31/1986,1,271,10,0,4,286
08/31/1986,4,284,1,0,1,290
09/30/1986,0,291,0,0,0,291
10/31/1986,1,292,2,0,1,296
11/30/1986,1,291,4,0,1,297
12/31/1986,1,296,2,0,6,305
01/31/1987,0,303,0,0,2,305
02/28/1987,0,300,1,0,4,305
03/31/1987,1,301,0,0,4,306
04/30/1987,1,306,1,1,5,314
05/31/1987,0,310,1,0,6,317
06/30/1987,0,311,3,0,2,316
07/31/1987,3,309,1,1,4,318
08/31/1987,0,322,1,0,1,324
09/30/1987,0,319,3,0,1,323
10/31/1987,0,323,0,0,3,326
11/30/1987,0,319,3,0,4,326
12/31/1987,1,313,1,1,6,322
01/31/1988,2,309,0,0,4,315
02/29/1988,0,307,1,3,1,312
03/31/1988,4,298,2,0,4,308
04/30/1988,0,298,8,1,3,310
05/31/1988,0,303,0,1,4,308
06/30/1988,0,300,5,0,2,307
07/31/1988,3,301,3,1,0,308
08/31/1988,0,307,2,0,2,311
09/30/1988,0,309,2,0,0,311
10/31/1988,0,313,4,0,3,320
11/30/1988,0,309,8,0,4,321
12/31/1988,1,315,1,0,2,319
01/31/1989,1,315,1,0,1,318
02/28/1989,1,316,0,0,2,319
03/31/1989,2,308,5,0,2,317
04/30/1989,1,315,0,0,1,317
05/31/1989,0,316,0,0,4,320
06/30/1989,0,313,0,1,9,323
07/31/1989,1,309,0,0,6,316
08/31/1989,2,308,2,1,2,315
09/30/1989,1,312,0,0,0,313
10/31/1989,1,314,2,1,0,318
11/30/1989,4,306,1,1,7,319
12/31/1989,0,305,3,0,3,311
01/31/1990,0,303,0,3,3,309
02/28/1990,2,292,5,0,5,304
03/31/1990,1,294,3,0,2,300
04/30/1990,0,295,1,1,1,298
05/31/1990,2,290,2,1,2,297
06/30/1990,0,292,3,1,1,297
07/31/1990,0,287,4,1,3,295
08/31/1990,5,279,1,2,6,293
09/30/1990,1,281,1,2,2,287
10/31/1990,0,278,1,2,2,283
11/30/1990,1,274,2,2,2,281
12/31/1990,0,274,4,0,0,278
01/31/1991,0,274,1,3,1,279
02/28/1991,2,266,4,3,1,276
03/31/1991,1,270,1,1,0,273
04/30/1991,0,274,0,0,3,277
05/31/1991,0,272,3,1,1,277
06/30/1991,2,273,0,2,1,278
07/31/1991,3,269,1,2,1,276
08/31/1991,0,273,0,0,1,274
09/30/1991,0,273,1,0,1,275
10/31/1991,0,273,1,2,0,276
11/30/1991,2,271,1,1,1,276
12/31/1991,5,269,0,2,0,276
01/31/1992,1,271,1,1,1,275
02/29/1992,4,268,1,1,0,274
03/31/1992,5,271,1,0,1,278
04/30/1992,3,278,2,0,3,286
05/31/1992,0,281,4,0,0,285
06/30/1992,2,283,0,0,2,287
07/31/1992,0,288,1,1,0,290
08/31/1992,1,292,0,0,1,294
09/30/1992,0,289,1,2,1,293
10/31/1992,1,288,2,2,3,296
11/30/1992,2,284,1,1,6,294
12/31/1992,0,286,0,0,4,290
01/31/1993,2,284,1,0,1,288
02/28/1993,0,289,0,2,1,292
03/31/1993,0,289,3,0,3,295
04/30/1993,2,286,0,0,7,295
05/31/1993,2,286,1,0,0,289
06/30/1993,4,291,1,0,2,298
07/31/1993,2,295,0,0,3,300
08/31/1993,0,304,1,0,1,306
09/30/1993,2,299,2,0,5,308
10/31/1993,1,301,0,0,11,313
11/30/1993,1,308,3,0,3,315
12/31/1993,1,309,0,0,7,317
01/31/1994,2,308,1,1,1,313
02/28/1994,1,312,0,0,2,315
03/31/1994,0,313,0,0,2,315
04/30/1994,1,312,2,0,1,316
05/31/1994,0,318,0,0,0,318
06/30/1994,0,322,1,0,1,324
07/31/1994,2,315,4,0,3,324
08/31/1994,0,322,1,2,0,325
09/30/1994,0,324,1,0,0,325
10/31/1994,1,325,1,0,1,328
11/30/1994,2,324,4,0,1,331
12/31/1994,1,327,2,1,1,332
01/31/1995,0,326,2,2,2,332
02/28/1995,1,322,3,0,3,329
03/31/1995,2,320,3,0,3,328
04/30/1995,0,330,0,0,1,331
05/31/1995,3,330,5,1,1,340
06/30/1995,2,335,2,1,3,343
07/31/1995,0,335,0,1,7,343
08/31/1995,0,333,3,3,0,339
09/30/1995,0,339,2,0,2,343
10/31/1995,2,340,3,0,4,349
11/30/1995,4,338,4,0,1,347
12/31/1995,0,343,4,3,1,351
01/31/1996,1,342,5,1,0,349
02/29/1996,0,342,3,1,5,351
03/31/1996,0,348,2,1,2,353
04/30/1996,3,343,2,0,5,353
05/31/1996,2,347,1,0,2,352
06/30/1996,0,353,2,0,2,357
07/31/1996,1,356,0,1,5,363
08/31/1996,1,355,0,0,3,359
09/30/1996,0,351,5,0,3,359
10/31/1996,2,364,0,1,0,367
11/30/1996,3,366,3,1,1,374
12/31/1996,1,374,2,0,2,379
01/31/1997,0,373,3,0,7,383
02/28/1997,2,377,3,0,1,383
03/31/1997,2,379,2,0,1,384
04/30/1997,5,383,1,0,2,391
05/31/1997,4,383,3,0,4,394
06/30/1997,1,392,1,0,2,396
07/31/1997,2,391,3,4,3,403
08/31/1997,0,392,4,0,2,398
09/30/1997,1,395,2,2,2,402
10/31/1997,1,402,1,0,2,406
11/30/1997,0,405,4,2,2,413
12/31/1997,0,409,7,1,4,421
01/31/1998,3,414,4,2,2,425
02/28/1998,5,411,5,2,6,429
03/31/1998,2,421,1,2,1,427
04/30/1998,2,432,3,0,2,439
05/31/1998,2,443,3,0,3,451
06/30/1998,4,453,1,0,0,458
07/31/1998,0,468,0,0,1,469
08/31/1998,0,469,2,0,3,474
09/30/1998,0,475,1,1,2,479
10/31/1998,1,474,4,1,1,481
11/30/1998,2,469,1,0,7,479
12/31/1998,0,469,0,3,3,475
01/31/1999,2,453,9,3,4,471
02/28/1999,3,461,2,0,1,467
03/31/1999,0,460,6,1,6,473
04/30/1999,0,454,7,2,9,472
05/31/1999,0,462,3,4,1,470
06/30/1999,4,458,3,1,4,470
07/31/1999,0,469,4,0,1,474
08/31/1999,0,478,2,0,1,481
09/30/1999,2,473,4,2,4,485
10/31/1999,1,473,5,1,4,484
11/30/1999,2,469,6,1,4,482
12/31/1999,0,476,2,2,1,481
01/31/2000,0,469,7,3,3,482
02/29/2000,0,470,8,2,1,481
03/31/2000,5,468,8,1,0,482
04/30/2000,0,480,3,2,1,486
05/31/2000,1,477,6,1,1,486
06/30/2000,1,484,0,5,0,490
07/31/2000,2,483,3,0,0,488
08/31/2000,1,478,6,2,2,489
09/30/2000,1,481,2,1,3,488
10/31/2000,2,475,3,2,6,488
11/30/2000,3,468,9,5,0,485
12/31/2000,2,464,10,4,7,487
01/31/2001,0,471,4,4,0,479
02/28/2001,0,472,4,2,1,479
03/31/2001,1,465,6,4,1,477
04/30/2001,0,467,7,1,2,477
05/31/2001,1,464,6,3,1,475
06/30/2001,1,470,3,3,1,478
07/31/2001,2,472,3,1,1,479
08/31/2001,3,458,10,3,5,479
09/30/2001,0,463,7,1,4,475
10/31/2001,0,449,14,1,6,470
11/30/2001,0,454,6,6,1,467
12/31/2001,1,447,9,0,6,463
01/31/2002,1,446,4,5,1,457
02/28/2002,1,446,2,3,1,453
03/31/2002,1,442,5,2,1,451
04/30/2002,0,438,9,1,2,450
05/31/2002,3,443,5,2,2,455
06/30/2002,4,450,1,0,2,457
07/31/2002,2,450,3,1,2,458
08/31/2002,0,453,3,2,3,461
09/30/2002,0,454,1,0,2,457
10/31/2002,2,452,2,0,1,457
11/30/2002,0,450,6,1,1,458
12/31/2002,4,443,6,0,8,461
01/31/2003,0,447,4,2,3,456
02/28/2003,0,444,9,1,1,455
03/31/2003,1,450,4,0,2,457
04/30/2003,0,447,4,1,4,456
05/31/2003,0,448,4,3,0,455
06/30/2003,3,441,7,2,3,456
07/31/2003,1,443,5,2,4,455
08/31/2003,0,452,4,0,3,459
09/30/2003,1,450,5,1,3,460
10/31/2003,0,451,5,1,4,461
11/30/2003,1,472,4,0,3,480
12/31/2003,1,474,8,3,1,487
01/31/2004,0,484,4,0,1,489
02/29/2004,1,476,6,0,6,489
03/31/2004,1,489,2,3,1,496
04/30/2004,8,493,4,0,1,506
05/31/2004,1,501,2,1,2,507
06/30/2004,2,504,1,0,3,510
07/31/2004,3,508,3,0,3,517
08/31/2004,0,514,1,0,1,516
09/30/2004,3,508,1,1,4,517
10/31/2004,0,513,3,0,5,521
11/30/2004,1,512,3,1,3,520
12/31/2004,1,511,1,2,4,519
01/31/2005,0,512,1,1,1,515
02/28/2005,1,511,2,1,3,518
03/31/2005,2,507,5,0,3,517
04/30/2005,1,513,3,0,1,518
05/31/2005,3,507,5,0,6,521
06/30/2005,0,506,4,1,5,516
07/31/2005,3,503,8,1,7,522
08/31/2005,1,506,8,0,6,521
09/30/2005,3,500,10,0,6,519
10/31/2005,0,509,4,0,3,516
11/30/2005,1,512,2,0,1,516
12/31/2005,2,515,0,0,6,523
01/31/2006,0,514,1,0,3,518
02/28/2006,2,512,3,0,2,519
03/31/2006,1,514,6,0,2,523
04/30/2006,2,514,3,0,6,525
05/31/2006,4,516,2,0,2,524
06/30/2006,1,509,4,1,10,525
07/31/2006,0,511,2,0,3,516
08/31/2006,2,510,3,0,2,517
09/30/2006,2,509,2,0,4,517
10/31/2006,0,507,5,0,5,517
11/30/2006,0,508,4,1,3,516
12/31/2006,2,510,2,0,2,516
01/31/2007,1,487,3,0,26,517
02/28/2007,1,489,3,0,5,498
03/31/2007,1,487,5,0,4,497
04/30/2007,1,490,1,0,4,496
05/31/2007,3,490,5,0,3,501
06/30/2007,2,494,6,1,2,505
07/31/2007,4,492,10,0,5,511
08/31/2007,4,491,6,1,7,509
09/30/2007,0,493,5,1,5,504
10/31/2007,2,494,2,0,3,501
11/30/2007,3,492,0,0,7,502
12/31/2007,1,490,3,0,2,496
01/31/2008,0,493,0,1,0,494
02/29/2008,0,484,3,0,6,493
03/31/2008,5,477,4,1,1,488
04/30/2008,3,479,4,1,1,488
05/31/2008,4,476,2,1,5,488
06/30/2008,1,476,5,0,1,483
07/31/2008,1,476,2,2,3,484
08/31/2008,2,475,5,0,4,486
09/30/2008,1,473,6,0,2,482
10/31/2008,2,467,4,2,7,482
11/30/2008,0,461,9,2,2,474
12/31/2008,0,454,11,4,2,471
01/31/2009,0,456,5,3,3,467
02/28/2009,1,448,8,2,2,461
03/31/2009,0,447,7,3,1,458
04/30/2009,2,431,10,4,11,458
05/31/2009,2,437,4,1,1,445
06/30/2009,2,430,6,4,1,443
07/31/2009,1,435,2,1,0,439
08/31/2009,1,432,2,3,0,438
09/30/2009,2,429,4,1,0,436
10/31/2009,3,436,0,1,1,441
11/30/2009,2,438,2,1,1,444
12/31/2009,3,441,1,1,0,446
01/31/2010,5,440,0,0,2,447
02/28/2010,2,439,6,0,1,448
03/31/2010,2,439,1,2,6,450
04/30/2010,2,445,2,0,1,450
05/31/2010,3,445,2,1,3,454
06/30/2010,4,440,2,0,6,452
07/31/2010,0,440,1,3,2,446
08/31/2010,1,444,0,0,4,449
09/30/2010,0,448,1,0,0,449
10/31/2010,1,445,2,1,4,453
11/30/2010,2,448,1,0,2,453
12/31/2010,1,449,3,2,5,460
01/31/2011,3,442,9,0,3,457
02/28/2011,5,451,2,1,7,466
03/31/2011,3,450,5,1,4,463
04/30/2011,2,458,3,3,3,469
05/31/2011,4,455,7,0,5,471
06/30/2011,3,466,2,1,3,475
07/31/2011,1,469,1,1,1,473
08/31/2011,1,471,1,0,4,477
09/30/2011,3,470,3,0,4,480
10/31/2011,2,478,0,1,1,482
11/30/2011,2,478,4,0,1,485
12/31/2011,2,481,0,0,3,486
01/31/2012,1,477,6,1,1,486
02/29/2012,1,483,2,1,5,492
03/31/2012,2,485,1,0,4,492
04/30/2012,4,485,1,1,3,494
05/31/2012,2,490,1,1,4,498
06/30/2012,1,493,2,0,4,500
07/31/2012,1,497,3,0,3,504
08/31/2012,1,506,2,0,2,511
09/30/2012,1,510,2,0,2,515
10/31/2012,1,504,2,0,9,516
11/30/2012,2,512,1,0,2,517
12/31/2012,1,519,2,0,2,524
01/31/2013,0,523,1,0,4,528
02/28/2013,0,525,2,0,5,532
03/31/2013,0,534,2,1,3,540
04/30/2013,1,538,5,0,3,547
05/31/2013,2,553,3,1,3,562
06/30/2013,1,569,1,1,4,576
07/31/2013,1,569,2,1,4,577
08/31/2013,2,577,0,0,1,580
09/30/2013,0,581,1,0,2,584
10/31/2013,4,584,0,0,2,590
11/30/2013,3,590,1,0,2,596
12/31/2013,4,596,1,0,6,607
01/31/2014,2,598,1,0,4,605
02/28/2014,2,603,2,0,4,611
03/31/2014,2,606,2,2,1,613
04/30/2014,3,606,2,1,6,618
05/31/2014,1,610,4,0,9,624
06/30/2014,1,615,3,0,3,622
07/31/2014,5,615,0,1,7,628
08/31/2014,1,625,2,1,2,631
09/30/2014,2,618,5,1,8,634
10/31/2014,1,638,2,0,4,645
11/30/2014,2,638,3,0,6,649
12/31/2014,1,640,5,0,4,650
01/31/2015,0,646,2,1,2,651
02/28/2015,1,643,2,2,5,653
03/31/2015,2,640,0,0,5,647
04/30/2015,2,632,8,1,1,644
05/31/2015,1,635,2,1,6,645
06/30/2015,3,630,3,0,7,643
07/31/2015,0,631,3,1,8,643
08/31/2015,2,629,4,2,5,642
09/30/2015,0,633,2,2,3,640
10/31/2015,4,625,2,3,4,638
11/30/2015,1,632,3,1,0,637
12/31/2015,2,628,4,1,4,639
01/31/2016,1,622,4,1,6,634
02/29/2016,1,620,7,0,4,632
03/31/2016,2,619,4,0,6,631
04/30/2016,2,617,5,3,4,631
05/31/2016,2,618,5,4,2,631
06/30/2016,4,625,2,0,0,631
07/31/2016,2,628,2,0,8,640
08/31/2016,1,632,2,1,3,639
09/30/2016,0,627,1,2,8,638
10/31/2016,1,628,3,0,6,638
11/30/2016,2,629,2,1,7,641
12/31/2016,0,636,4,0,6,646
01/31/2017,1,632,6,0,2,641
02/28/2017,2,634,8,0,1,645
03/31/2017,2,634,8,0,6,650
04/30/2017,2,639,5,1,5,652
05/31/2017,1,641,4,3,9,658
06/30/2017,0,636,6,2,7,651
07/31/2017,3,635,2,2,5,647
08/31/2017,2,623,9,1,11,646
09/30/2017,0,622,6,1,8,637
10/31/2017,0,635,2,0,1,638
11/30/2017,1,640,2,2,1,646
12/31/2017,1,635,6,3,4,649
01/31/2018,3,645,3,0,0,651
02/28/2018,0,649,2,3,3,657
03/31/2018,4,634,11,3,5,657
04/30/2018,1,649,6,2,2,660
05/31/2018,3,655,3,1,6,668
06/30/2018,1,657,3,1,9,671
07/31/2018,0,661,1,2,6,670
08/31/2018,3,662,5,0,4,674
09/30/2018,1,669,3,0,5,678
10/31/2018,3,671,4,2,4,684
11/30/2018,1,680,3,1,2,687
12/31/2018,0,682,8,0,2,692
01/31/2019,4,679,3,1,6,693
02/28/2019,2,685,0,2,1,690
03/31/2019,1,680,11,2,4,698
04/30/2019,2,687,6,3,1,699
05/31/2019,1,691,5,1,4,702
06/30/2019,2,691,4,2,4,703
07/31/2019,1,698,5,1,1,706
08/31/2019,2,703,4,0,2,711
09/30/2019,2,700,5,2,3,712
10/31/2019,1,703,2,4,4,714
11/30/2019,1,705,4,2,3,715
12/31/2019,0,700,7,3,6,716
01/31/2020,1,704,1,3,3,712
02/29/2020,2,694,6,4,6,712
03/31/2020,1,668,33,1,5,708
04/30/2020,0,656,35,7,6,704
05/31/2020,0,681,8,6,3,698
06/30/2020,4,668,6,9,3,690
07/31/2020,2,668,2,8,5,685
08/31/2020,2,672,3,2,3,682
09/30/2020,3,671,4,4,5,687
10/31/2020,4,670,3,5,3,685
11/30/2020,4,685,4,3,3,699
12/31/2020,3,691,1,0,5,700
01/31/2021,4,696,3,1,3,707
02/28/2021,1,703,0,3,6,713
03/31/2021,3,703,3,0,6,715
04/30/2021,4,709,3,3,6,725
05/31/2021,9,715,2,0,4,730
06/30/2021,5,724,2,0,7,738
07/31/2021,5,735,0,1,5,746
08/31/2021,5,738,4,0,7,754
09/30/2021,3,742,2,1,9,757
