Up/Down,Upgrade,Same,Downgrade,Defaulted,Non-Rated,Totals
01/31/1981,1,108,7,0,0,116
02/28/1981,1,116,0,0,0,117
03/31/1981,0,116,1,0,0,117
04/30/1981,0,116,2,0,0,118
05/31/1981,0,116,1,0,1,118
06/30/1981,1,116,0,0,0,117
07/31/1981,0,118,0,0,0,118
08/31/1981,0,117,1,0,0,118
09/30/1981,0,119,0,0,0,119
10/31/1981,0,120,0,0,0,120
11/30/1981,0,119,1,0,0,120
12/31/1981,2,119,0,0,0,121
01/31/1982,0,117,4,0,2,123
02/28/1982,1,120,0,0,0,121
03/31/1982,0,120,0,0,1,121
04/30/1982,0,119,0,0,1,120
05/31/1982,0,119,0,0,0,119
06/30/1982,0,119,0,0,1,120
07/31/1982,0,118,0,0,1,119
08/31/1982,0,116,2,0,1,119
09/30/1982,0,118,1,0,1,120
10/31/1982,1,118,1,0,0,120
11/30/1982,1,117,1,0,4,123
12/31/1982,0,114,3,1,1,119
01/31/1983,0,118,0,0,0,118
02/28/1983,0,117,1,0,0,118
03/31/1983,2,116,1,0,0,119
04/30/1983,0,124,2,0,1,127
05/31/1983,0,126,0,0,0,126
06/30/1983,0,123,5,0,1,129
07/31/1983,0,129,1,0,0,130
08/31/1983,1,128,0,0,1,130
09/30/1983,0,129,0,1,0,130
10/31/1983,0,128,1,0,0,129
11/30/1983,0,121,6,2,0,129
12/31/1983,0,126,0,0,1,127
01/31/1984,0,125,0,0,2,127
02/29/1984,2,123,0,1,0,126
03/31/1984,0,122,3,0,0,125
04/30/1984,0,116,5,2,2,125
05/31/1984,0,118,2,1,1,122
06/30/1984,1,118,1,0,0,120
07/31/1984,0,120,1,1,0,122
08/31/1984,0,119,2,0,0,121
09/30/1984,1,120,1,0,0,122
10/31/1984,0,120,1,2,0,123
11/30/1984,0,122,0,0,0,122
12/31/1984,0,121,0,0,2,123
01/31/1985,1,119,0,1,1,122
02/28/1985,0,124,1,0,0,125
03/31/1985,0,120,1,1,3,125
04/30/1985,0,119,1,0,1,121
05/31/1985,0,112,6,1,1,120
06/30/1985,0,115,2,0,1,118
07/31/1985,0,114,2,0,1,117
08/31/1985,0,115,0,2,0,117
09/30/1985,0,115,0,0,0,115
10/31/1985,0,116,0,0,0,116
11/30/1985,0,115,1,0,1,117
12/31/1985,0,115,3,0,0,118
01/31/1986,0,115,0,1,3,119
02/28/1986,0,116,1,0,0,117
03/31/1986,0,114,2,2,0,118
04/30/1986,2,109,2,2,2,117
05/31/1986,0,108,3,1,1,113
06/30/1986,1,107,2,2,0,112
07/31/1986,3,90,18,2,0,113
08/31/1986,0,109,2,0,3,114
09/30/1986,0,109,0,1,1,111
10/31/1986,0,107,1,0,1,109
11/30/1986,1,105,2,0,0,108
12/31/1986,0,108,0,1,1,110
01/31/1987,1,104,0,1,5,111
02/28/1987,0,102,2,1,1,106
03/31/1987,3,101,0,0,1,105
04/30/1987,0,102,0,3,2,107
05/31/1987,0,103,0,0,1,104
06/30/1987,1,101,1,0,0,103
07/31/1987,1,99,1,0,2,103
08/31/1987,1,101,0,0,0,102
09/30/1987,0,102,0,0,0,102
10/31/1987,2,98,0,0,2,102
11/30/1987,0,100,0,0,0,100
12/31/1987,0,100,0,0,0,100
01/31/1988,0,100,0,0,2,102
02/29/1988,0,94,0,2,4,100
03/31/1988,1,89,1,0,3,94
04/30/1988,4,85,1,0,1,91
05/31/1988,3,86,0,0,3,92
06/30/1988,0,90,0,0,0,90
07/31/1988,0,89,2,0,0,91
08/31/1988,1,89,0,0,1,91
09/30/1988,1,90,0,0,0,91
10/31/1988,1,88,1,0,2,92
11/30/1988,0,90,0,0,0,90
12/31/1988,0,89,0,0,1,90
01/31/1989,1,87,0,0,1,89
02/28/1989,4,87,0,0,0,91
03/31/1989,1,89,1,0,1,92
04/30/1989,0,93,0,0,0,93
05/31/1989,0,92,1,0,0,93
06/30/1989,0,91,0,0,2,93
07/31/1989,0,92,0,0,0,92
08/31/1989,0,92,0,0,1,93
09/30/1989,0,89,1,0,2,92
10/31/1989,0,91,1,0,0,92
11/30/1989,0,92,0,0,1,93
12/31/1989,0,92,0,0,0,92
01/31/1990,0,91,0,0,1,92
02/28/1990,0,89,2,0,1,92
03/31/1990,0,89,1,0,1,91
04/30/1990,0,93,0,0,0,93
05/31/1990,0,93,1,0,0,94
06/30/1990,1,93,0,0,0,94
07/31/1990,0,94,0,0,1,95
08/31/1990,2,92,0,0,0,94
09/30/1990,0,93,0,0,1,94
10/31/1990,1,92,0,0,0,93
11/30/1990,0,92,1,0,1,94
12/31/1990,0,93,0,0,0,93
01/31/1991,0,92,0,0,1,93
02/28/1991,0,90,2,0,0,92
03/31/1991,0,92,0,0,0,92
04/30/1991,1,91,0,0,0,92
05/31/1991,0,90,1,0,1,92
06/30/1991,0,89,2,0,0,91
07/31/1991,0,91,0,0,0,91
08/31/1991,0,91,0,0,0,91
09/30/1991,0,92,0,0,0,92
10/31/1991,1,92,0,0,0,93
11/30/1991,0,95,0,1,0,96
12/31/1991,0,98,1,1,0,100
01/31/1992,0,98,1,0,0,99
02/29/1992,0,95,3,0,1,99
03/31/1992,0,98,0,0,0,98
04/30/1992,0,99,0,0,0,99
05/31/1992,0,99,0,0,0,99
06/30/1992,0,100,0,0,0,100
07/31/1992,1,100,1,0,0,102
08/31/1992,0,102,1,1,0,104
09/30/1992,0,105,0,0,0,105
10/31/1992,1,106,0,0,0,107
11/30/1992,0,105,1,0,2,108
12/31/1992,0,108,0,0,1,109
01/31/1993,0,107,2,0,0,109
02/28/1993,0,109,0,0,0,109
03/31/1993,0,109,0,1,0,110
04/30/1993,1,111,0,0,1,113
05/31/1993,0,110,3,0,1,114
06/30/1993,0,115,0,1,0,116
07/31/1993,0,116,0,0,1,117
08/31/1993,2,118,0,0,1,121
09/30/1993,1,118,2,0,1,122
10/31/1993,0,120,0,0,1,121
11/30/1993,1,121,0,0,0,122
12/31/1993,0,119,0,0,4,123
01/31/1994,0,122,0,0,0,122
02/28/1994,0,125,0,0,0,125
03/31/1994,0,121,1,0,3,125
04/30/1994,0,123,1,0,2,126
05/31/1994,0,124,0,0,2,126
06/30/1994,0,127,0,0,0,127
07/31/1994,0,127,1,0,0,128
08/31/1994,0,129,0,0,0,129
09/30/1994,0,129,1,0,1,131
10/31/1994,1,127,1,0,1,130
11/30/1994,0,129,1,0,1,131
12/31/1994,0,132,0,0,0,132
01/31/1995,0,133,0,0,1,134
02/28/1995,0,132,0,0,1,133
03/31/1995,1,132,1,0,0,134
04/30/1995,0,137,0,0,0,137
05/31/1995,1,139,0,1,0,141
06/30/1995,2,137,1,0,2,142
07/31/1995,0,142,0,0,1,143
08/31/1995,0,142,0,0,1,143
09/30/1995,0,141,0,0,1,142
10/31/1995,1,141,0,0,0,142
11/30/1995,0,143,0,0,0,143
12/31/1995,1,146,0,0,0,147
01/31/1996,0,147,0,0,1,148
02/29/1996,0,146,1,1,0,148
03/31/1996,1,148,0,0,0,149
04/30/1996,0,149,0,0,0,149
05/31/1996,1,149,0,0,0,150
06/30/1996,0,153,1,0,0,154
07/31/1996,2,152,0,0,1,155
08/31/1996,2,152,0,0,1,155
09/30/1996,0,155,1,0,0,156
10/31/1996,1,157,0,0,0,158
11/30/1996,2,162,0,0,0,164
12/31/1996,2,165,0,0,0,167
01/31/1997,0,169,0,0,0,169
02/28/1997,0,170,0,0,2,172
03/31/1997,0,173,0,0,0,173
04/30/1997,2,174,0,0,0,176
05/31/1997,3,171,0,0,4,178
06/30/1997,0,176,1,0,4,181
07/31/1997,0,179,0,0,3,182
08/31/1997,1,177,0,0,2,180
09/30/1997,1,181,0,0,0,182
10/31/1997,1,185,1,0,3,190
11/30/1997,1,190,1,0,0,192
12/31/1997,1,190,1,0,1,193
01/31/1998,0,192,1,0,0,193
02/28/1998,0,196,0,0,0,196
03/31/1998,2,198,1,0,0,201
04/30/1998,3,196,2,0,2,203
05/31/1998,1,200,0,0,3,204
06/30/1998,1,203,0,0,1,205
07/31/1998,1,208,4,0,0,213
08/31/1998,0,209,2,0,4,215
09/30/1998,0,211,1,0,0,212
10/31/1998,1,216,0,0,1,218
11/30/1998,0,216,2,1,1,220
12/31/1998,1,208,5,1,3,218
01/31/1999,0,210,3,0,1,214
02/28/1999,0,211,3,0,0,214
03/31/1999,1,204,6,2,3,216
04/30/1999,1,199,8,2,3,213
05/31/1999,0,201,5,1,3,210
06/30/1999,0,201,6,1,1,209
07/31/1999,0,204,0,2,3,209
08/31/1999,0,199,1,2,4,206
09/30/1999,3,194,1,0,2,200
10/31/1999,0,199,2,1,0,202
11/30/1999,3,194,3,1,0,201
12/31/1999,0,197,0,1,2,200
01/31/2000,0,198,1,0,1,200
02/29/2000,0,200,0,0,1,201
03/31/2000,0,196,3,0,2,201
04/30/2000,3,195,0,0,2,200
05/31/2000,0,194,2,0,3,199
06/30/2000,0,197,0,0,0,197
07/31/2000,1,195,0,1,1,198
08/31/2000,1,195,0,0,1,197
09/30/2000,1,196,0,0,1,198
10/31/2000,1,196,0,0,1,198
11/30/2000,0,199,1,0,0,200
12/31/2000,2,201,0,0,0,203
01/31/2001,3,196,2,0,5,206
02/28/2001,3,196,1,1,1,202
03/31/2001,1,200,1,1,0,203
04/30/2001,1,202,0,1,0,204
05/31/2001,0,207,0,0,0,207
06/30/2001,2,205,1,0,0,208
07/31/2001,0,210,1,0,1,212
08/31/2001,0,214,0,0,3,217
09/30/2001,1,211,1,0,4,217
10/31/2001,0,212,1,0,2,215
11/30/2001,0,205,6,0,4,215
12/31/2001,0,208,2,1,3,214
01/31/2002,0,207,2,1,1,211
02/28/2002,0,210,0,0,1,211
03/31/2002,2,210,0,0,0,212
04/30/2002,1,209,1,1,0,212
05/31/2002,1,207,4,0,1,213
06/30/2002,3,208,0,1,2,214
07/31/2002,1,207,5,0,2,215
08/31/2002,0,213,1,0,1,215
09/30/2002,0,211,1,0,2,214
10/31/2002,0,209,4,1,0,214
11/30/2002,0,207,3,0,3,213
12/31/2002,1,201,12,0,0,214
01/31/2003,0,210,2,0,4,216
02/28/2003,1,208,2,1,1,213
03/31/2003,0,210,0,0,1,211
04/30/2003,0,209,1,0,1,211
05/31/2003,3,204,2,0,1,210
06/30/2003,2,209,0,0,1,212
07/31/2003,2,208,1,1,0,212
08/31/2003,2,211,0,0,2,215
09/30/2003,0,215,0,0,1,216
10/31/2003,1,218,0,0,1,220
11/30/2003,2,224,0,1,0,227
12/31/2003,1,227,0,0,0,228
01/31/2004,1,228,1,0,0,230
02/29/2004,2,227,0,0,4,233
03/31/2004,1,225,2,0,3,231
04/30/2004,0,225,4,0,2,231
05/31/2004,0,231,1,1,2,235
06/30/2004,2,227,2,0,3,234
07/31/2004,0,233,1,0,1,235
08/31/2004,1,235,0,0,1,237
09/30/2004,0,235,1,0,1,237
10/31/2004,0,234,1,0,1,236
11/30/2004,0,236,1,0,1,238
12/31/2004,0,238,0,1,2,241
01/31/2005,0,243,0,0,0,243
02/28/2005,0,243,2,0,1,246
03/31/2005,1,242,2,0,2,247
04/30/2005,0,244,4,0,1,249
05/31/2005,0,244,1,1,4,250
06/30/2005,1,245,1,0,2,249
07/31/2005,3,248,0,0,1,252
08/31/2005,4,250,0,0,2,256
09/30/2005,2,250,0,0,3,255
10/31/2005,0,252,2,0,2,256
11/30/2005,0,258,1,0,0,259
12/31/2005,1,255,2,0,4,262
01/31/2006,0,265,0,0,0,265
02/28/2006,2,263,0,0,5,270
03/31/2006,0,267,0,0,0,267
04/30/2006,1,265,0,0,3,269
05/31/2006,1,269,2,0,2,274
06/30/2006,0,274,1,0,1,276
07/31/2006,3,272,2,0,0,277
08/31/2006,1,275,3,0,1,280
09/30/2006,1,275,1,0,2,279
10/31/2006,3,276,0,0,2,281
11/30/2006,1,278,1,0,2,282
12/31/2006,3,279,0,0,2,284
01/31/2007,1,283,1,0,3,288
02/28/2007,0,295,0,0,0,295
03/31/2007,1,295,0,0,0,296
04/30/2007,2,298,0,0,0,300
05/31/2007,0,300,1,0,5,306
06/30/2007,2,300,1,0,2,305
07/31/2007,2,298,4,0,4,308
08/31/2007,2,305,1,0,4,312
09/30/2007,1,307,0,0,1,309
10/31/2007,1,305,1,0,2,309
11/30/2007,3,306,0,0,3,312
12/31/2007,0,309,0,0,3,312
01/31/2008,2,304,1,0,2,309
02/29/2008,0,308,1,0,1,310
03/31/2008,2,305,2,0,0,309
04/30/2008,3,306,1,0,2,312
05/31/2008,1,307,1,0,2,311
06/30/2008,1,308,1,0,0,310
07/31/2008,5,309,0,0,0,314
08/31/2008,1,317,1,0,2,321
09/30/2008,3,315,0,0,1,319
10/31/2008,0,310,3,1,5,319
11/30/2008,0,309,4,1,1,315
12/31/2008,1,306,4,2,1,314
01/31/2009,0,303,5,0,4,312
02/28/2009,1,298,8,1,0,308
03/31/2009,1,301,4,0,2,308
04/30/2009,0,300,2,3,3,308
05/31/2009,0,294,5,1,2,302
06/30/2009,0,297,3,1,0,301
07/31/2009,0,297,4,1,2,304
08/31/2009,0,302,1,1,4,308
09/30/2009,2,299,2,1,0,304
10/31/2009,3,303,1,0,0,307
11/30/2009,0,305,2,1,2,310
12/31/2009,1,307,0,1,1,310
01/31/2010,1,309,2,0,2,314
02/28/2010,1,316,1,0,0,318
03/31/2010,3,320,0,0,1,324
04/30/2010,4,319,0,0,2,325
05/31/2010,0,326,2,0,2,330
06/30/2010,1,315,9,1,3,329
07/31/2010,2,323,1,0,2,328
08/31/2010,2,325,2,0,2,331
09/30/2010,2,328,0,0,0,330
10/31/2010,0,333,0,0,0,333
11/30/2010,2,337,0,0,1,340
12/31/2010,2,338,2,0,4,346
01/31/2011,0,345,0,0,0,345
02/28/2011,0,347,0,0,3,350
03/31/2011,0,346,2,0,1,349
04/30/2011,3,349,2,0,1,355
05/31/2011,1,359,0,0,2,362
06/30/2011,1,364,0,1,6,372
07/31/2011,1,362,2,0,4,369
08/31/2011,1,363,1,0,1,366
09/30/2011,2,363,1,0,0,366
10/31/2011,0,365,2,0,1,368
11/30/2011,1,366,1,1,2,371
12/31/2011,3,360,4,3,2,372
01/31/2012,0,367,0,1,1,369
02/29/2012,1,374,2,0,1,378
03/31/2012,1,375,3,0,2,381
04/30/2012,1,382,1,0,1,385
05/31/2012,2,378,4,0,3,387
06/30/2012,1,390,1,0,0,392
07/31/2012,0,390,3,3,1,397
08/31/2012,0,393,3,1,1,398
09/30/2012,1,394,3,1,1,400
10/31/2012,1,397,1,0,5,404
11/30/2012,1,403,3,2,1,410
12/31/2012,0,418,2,1,1,422
01/31/2013,0,427,0,0,1,428
02/28/2013,0,431,2,0,2,435
03/31/2013,1,431,1,1,1,435
04/30/2013,2,433,3,0,3,441
05/31/2013,3,441,3,0,0,447
06/30/2013,0,453,2,0,3,458
07/31/2013,0,456,4,0,1,461
08/31/2013,1,460,3,1,0,465
09/30/2013,0,462,2,1,5,470
10/31/2013,2,467,2,2,1,474
11/30/2013,2,469,4,0,1,476
12/31/2013,6,463,7,3,2,481
01/31/2014,1,479,1,0,2,483
02/28/2014,1,479,2,1,2,485
03/31/2014,1,477,2,1,3,484
04/30/2014,1,481,1,2,1,486
05/31/2014,1,485,0,0,3,489
06/30/2014,1,482,2,0,4,489
07/31/2014,1,489,2,1,1,494
08/31/2014,0,511,1,4,5,521
09/30/2014,3,507,3,1,2,516
10/31/2014,0,517,1,1,2,521
11/30/2014,1,519,8,1,1,530
12/31/2014,0,519,4,1,8,532
01/31/2015,1,516,7,0,4,528
02/28/2015,0,512,11,3,4,530
03/31/2015,1,517,3,4,4,529
04/30/2015,1,504,8,4,6,523
05/31/2015,2,501,5,6,1,515
06/30/2015,0,501,12,2,1,516
07/31/2015,0,506,5,4,4,519
08/31/2015,1,509,0,5,0,515
09/30/2015,0,501,7,2,1,511
10/31/2015,0,492,12,2,3,509
11/30/2015,0,486,9,4,8,507
12/31/2015,0,477,12,5,3,497
01/31/2016,1,465,18,3,2,489
02/29/2016,0,437,40,7,2,486
03/31/2016,1,456,13,6,2,478
04/30/2016,1,446,12,11,1,471
05/31/2016,1,430,17,12,2,462
06/30/2016,1,439,9,6,2,457
07/31/2016,1,437,9,6,3,456
08/31/2016,1,442,4,5,2,454
09/30/2016,1,432,4,7,6,450
10/31/2016,0,434,5,6,3,448
11/30/2016,2,431,9,2,1,445
12/31/2016,1,434,6,6,1,448
01/31/2017,3,433,3,3,3,445
02/28/2017,5,439,1,1,0,446
03/31/2017,1,442,2,2,2,449
04/30/2017,1,442,3,3,2,451
05/31/2017,2,434,6,5,5,452
06/30/2017,3,441,2,1,3,450
07/31/2017,0,446,3,0,1,450
08/31/2017,3,446,2,2,1,454
09/30/2017,2,443,3,2,5,455
10/31/2017,1,446,4,0,4,455
11/30/2017,5,445,1,1,5,457
12/31/2017,2,447,1,4,0,454
01/31/2018,1,450,1,5,3,460
02/28/2018,5,460,1,0,1,467
03/31/2018,4,466,0,4,0,474
04/30/2018,1,473,1,0,3,478
05/31/2018,2,471,2,4,1,480
06/30/2018,2,472,3,1,4,482
07/31/2018,3,477,2,0,2,484
08/31/2018,3,482,1,0,7,493
09/30/2018,2,480,4,2,4,492
10/31/2018,1,491,1,1,2,496
11/30/2018,3,490,4,0,2,499
12/31/2018,0,493,4,1,3,501
01/31/2019,0,490,5,1,5,501
02/28/2019,2,487,6,1,6,502
03/31/2019,1,485,4,5,3,498
04/30/2019,3,485,1,3,1,493
05/31/2019,2,483,7,1,3,496
06/30/2019,0,487,2,2,3,494
07/31/2019,1,477,4,3,7,492
08/31/2019,0,476,3,2,2,483
09/30/2019,0,465,6,3,5,479
10/31/2019,0,463,5,1,4,473
11/30/2019,2,460,4,0,3,469
12/31/2019,0,457,5,1,6,469
01/31/2020,2,452,3,1,7,465
02/29/2020,0,443,7,1,9,460
03/31/2020,0,413,37,2,2,454
04/30/2020,0,414,27,7,3,451
05/31/2020,0,418,14,6,3,441
06/30/2020,3,413,6,11,2,435
07/31/2020,0,411,3,9,4,427
08/31/2020,0,410,3,4,2,419
09/30/2020,0,408,4,4,2,418
10/31/2020,1,412,1,3,0,417
11/30/2020,1,396,10,5,3,415
12/31/2020,1,400,4,2,4,411
01/31/2021,1,402,3,1,4,411
02/28/2021,1,404,4,3,0,412
03/31/2021,4,402,4,2,4,416
04/30/2021,6,400,5,3,3,417
05/31/2021,3,409,2,1,0,415
06/30/2021,0,420,2,1,0,423
07/31/2021,3,423,0,1,2,429
08/31/2021,1,424,1,1,2,429
09/30/2021,1,420,1,0,5,427
