Up/Down,Upgrade,Same,Downgrade,Defaulted,Non-Rated,Totals
01/31/1981,0,60,1,0,0,61
02/28/1981,0,59,4,0,0,63
03/31/1981,1,62,1,0,0,64
04/30/1981,0,64,1,0,0,65
05/31/1981,1,64,0,0,0,65
06/30/1981,0,67,0,0,0,67
07/31/1981,0,69,0,0,0,69
08/31/1981,0,68,1,0,0,69
09/30/1981,0,69,0,0,0,69
10/31/1981,0,69,0,0,0,69
11/30/1981,0,69,0,0,0,69
12/31/1981,2,65,2,0,0,69
01/31/1982,0,69,0,0,0,69
02/28/1982,0,70,0,0,0,70
03/31/1982,1,68,0,0,1,70
04/30/1982,1,67,2,0,0,70
05/31/1982,0,70,0,0,0,70
06/30/1982,0,70,0,0,0,70
07/31/1982,2,68,1,0,0,71
08/31/1982,0,71,0,0,0,71
09/30/1982,0,70,1,0,0,71
10/31/1982,0,69,0,0,2,71
11/30/1982,1,64,0,0,6,71
12/31/1982,0,63,1,1,1,66
01/31/1983,0,63,0,0,2,65
02/28/1983,0,65,0,0,0,65
03/31/1983,1,62,0,0,2,65
04/30/1983,0,65,0,0,1,66
05/31/1983,1,63,0,0,1,65
06/30/1983,0,66,2,0,0,68
07/31/1983,0,67,0,0,1,68
08/31/1983,0,65,1,0,1,67
09/30/1983,0,67,1,0,0,68
10/31/1983,0,67,0,0,2,69
11/30/1983,0,66,1,0,1,68
12/31/1983,0,67,0,0,0,67
01/31/1984,1,66,0,0,0,67
02/29/1984,1,64,2,0,0,67
03/31/1984,0,67,0,0,0,67
04/30/1984,0,66,1,0,0,67
05/31/1984,0,68,0,0,0,68
06/30/1984,0,70,0,0,0,70
07/31/1984,2,69,0,0,0,71
08/31/1984,0,71,0,0,0,71
09/30/1984,0,71,0,0,0,71
10/31/1984,0,69,2,0,0,71
11/30/1984,0,70,0,2,0,72
12/31/1984,0,69,0,0,1,70
01/31/1985,1,68,0,0,1,70
02/28/1985,0,67,2,0,1,70
03/31/1985,0,70,0,0,0,70
04/30/1985,0,69,3,0,0,72
05/31/1985,0,71,1,0,0,72
06/30/1985,1,73,0,0,0,74
07/31/1985,0,76,0,0,0,76
08/31/1985,0,76,0,0,0,76
09/30/1985,0,75,3,0,1,79
10/31/1985,0,78,1,0,0,79
11/30/1985,0,77,3,0,0,80
12/31/1985,0,81,0,0,0,81
01/31/1986,0,81,0,1,0,82
02/28/1986,0,79,1,1,2,83
03/31/1986,0,80,1,0,0,81
04/30/1986,0,82,0,0,1,83
05/31/1986,1,82,2,0,1,86
06/30/1986,0,83,3,0,0,86
07/31/1986,1,82,4,1,1,89
08/31/1986,0,85,0,0,2,87
09/30/1986,0,86,0,0,0,86
10/31/1986,0,83,0,0,3,86
11/30/1986,0,84,0,0,0,84
12/31/1986,3,80,0,0,1,84
01/31/1987,0,83,0,0,1,84
02/28/1987,0,85,0,0,0,85
03/31/1987,0,89,1,0,2,92
04/30/1987,0,94,0,0,1,95
05/31/1987,0,97,0,0,4,101
06/30/1987,0,95,2,0,2,99
07/31/1987,0,95,0,0,4,99
08/31/1987,6,91,0,0,0,97
09/30/1987,0,95,0,0,3,98
10/31/1987,0,94,0,0,2,96
11/30/1987,1,94,0,0,0,95
12/31/1987,0,95,0,0,1,96
01/31/1988,0,94,1,0,0,95
02/29/1988,0,96,0,0,0,96
03/31/1988,1,92,1,0,3,97
04/30/1988,0,90,1,0,3,94
05/31/1988,0,91,0,0,0,91
06/30/1988,0,91,0,0,1,92
07/31/1988,0,91,0,0,0,91
08/31/1988,0,94,0,0,0,94
09/30/1988,0,93,0,0,1,94
10/31/1988,0,94,0,0,0,94
11/30/1988,1,95,0,0,0,96
12/31/1988,0,96,0,0,0,96
01/31/1989,0,95,0,0,1,96
02/28/1989,0,93,1,0,1,95
03/31/1989,1,94,0,0,1,96
04/30/1989,0,93,1,0,1,95
05/31/1989,1,89,2,0,2,94
06/30/1989,0,92,0,0,2,94
07/31/1989,1,89,1,0,1,92
08/31/1989,1,87,1,0,2,91
09/30/1989,0,88,0,0,1,89
10/31/1989,0,87,0,0,1,88
11/30/1989,0,82,4,1,0,87
12/31/1989,0,86,0,0,0,86
01/31/1990,0,84,1,1,0,86
02/28/1990,0,83,2,0,0,85
03/31/1990,0,84,0,0,2,86
04/30/1990,1,78,0,2,3,84
05/31/1990,0,74,0,0,5,79
06/30/1990,0,73,0,0,3,76
07/31/1990,0,72,0,0,1,73
08/31/1990,0,70,0,0,2,72
09/30/1990,0,68,2,0,0,70
10/31/1990,0,67,3,0,0,70
11/30/1990,0,70,0,0,0,70
12/31/1990,0,70,0,0,0,70
01/31/1991,0,71,0,0,0,71
02/28/1991,0,68,3,0,0,71
03/31/1991,0,73,0,0,0,73
04/30/1991,1,70,1,0,1,73
05/31/1991,0,70,0,0,2,72
06/30/1991,0,69,0,1,2,72
07/31/1991,0,68,0,1,0,69
08/31/1991,0,68,0,0,0,68
09/30/1991,0,68,0,0,1,69
10/31/1991,1,66,0,0,1,68
11/30/1991,0,67,1,0,1,69
12/31/1991,1,67,0,0,1,69
01/31/1992,0,65,3,0,0,68
02/29/1992,0,68,0,0,0,68
03/31/1992,0,68,1,0,0,69
04/30/1992,0,71,0,0,0,71
05/31/1992,0,72,0,0,0,72
06/30/1992,1,73,0,0,0,74
07/31/1992,0,73,1,0,0,74
08/31/1992,2,72,0,1,1,76
09/30/1992,1,73,0,0,0,74
10/31/1992,0,73,0,1,0,74
11/30/1992,1,73,0,0,1,75
12/31/1992,0,74,0,0,2,76
01/31/1993,1,70,3,0,0,74
02/28/1993,0,74,0,0,1,75
03/31/1993,0,76,0,1,0,77
04/30/1993,0,76,0,0,1,77
05/31/1993,0,76,0,0,1,77
06/30/1993,0,75,1,1,1,78
07/31/1993,0,73,4,0,0,77
08/31/1993,0,78,0,0,1,79
09/30/1993,3,73,0,0,2,78
10/31/1993,1,77,0,0,0,78
11/30/1993,0,78,0,0,1,79
12/31/1993,0,79,0,0,2,81
01/31/1994,0,79,1,0,0,80
02/28/1994,0,81,0,0,1,82
03/31/1994,0,80,1,0,0,81
04/30/1994,1,82,0,0,0,83
05/31/1994,0,82,0,0,2,84
06/30/1994,0,82,0,0,0,82
07/31/1994,0,81,1,1,0,83
08/31/1994,1,81,1,0,0,83
09/30/1994,1,82,0,0,0,83
10/31/1994,0,84,0,0,0,84
11/30/1994,1,84,0,0,0,85
12/31/1994,0,87,1,0,0,88
01/31/1995,0,86,0,0,2,88
02/28/1995,0,86,0,0,0,86
03/31/1995,3,83,0,0,0,86
04/30/1995,1,80,1,1,3,86
05/31/1995,1,84,0,0,1,86
06/30/1995,0,86,0,0,2,88
07/31/1995,0,90,0,0,0,90
08/31/1995,0,90,0,0,1,91
09/30/1995,0,90,0,0,0,90
10/31/1995,0,90,0,0,2,92
11/30/1995,0,91,0,0,0,91
12/31/1995,0,89,0,0,2,91
01/31/1996,0,87,1,0,2,90
02/29/1996,2,83,2,0,1,88
03/31/1996,1,88,1,0,0,90
04/30/1996,0,89,2,0,2,93
05/31/1996,1,92,0,0,2,95
06/30/1996,0,93,0,0,1,94
07/31/1996,0,93,0,0,1,94
08/31/1996,1,91,1,0,1,94
09/30/1996,2,92,0,0,1,95
10/31/1996,0,94,0,0,1,95
11/30/1996,0,95,0,0,0,95
12/31/1996,0,97,0,0,2,99
01/31/1997,1,96,0,0,2,99
02/28/1997,1,99,0,0,0,100
03/31/1997,0,102,0,0,1,103
04/30/1997,0,102,0,0,1,103
05/31/1997,0,104,2,0,1,107
06/30/1997,0,108,0,1,0,109
07/31/1997,1,103,3,0,1,108
08/31/1997,0,108,0,0,2,110
09/30/1997,1,106,0,0,1,108
10/31/1997,0,108,2,0,0,110
11/30/1997,0,116,0,0,0,116
12/31/1997,0,119,1,0,1,121
01/31/1998,0,122,0,0,0,122
02/28/1998,0,124,0,0,4,128
03/31/1998,0,128,1,0,0,129
04/30/1998,1,131,1,0,0,133
05/31/1998,0,136,1,0,0,137
06/30/1998,2,142,0,0,0,144
07/31/1998,0,144,1,0,2,147
08/31/1998,1,147,1,0,0,149
09/30/1998,2,144,0,0,3,149
10/31/1998,0,146,1,0,1,148
11/30/1998,0,147,0,0,0,147
12/31/1998,2,145,2,0,1,150
01/31/1999,0,150,0,0,0,150
02/28/1999,1,147,0,0,2,150
03/31/1999,0,148,1,0,2,151
04/30/1999,1,144,1,0,4,150
05/31/1999,0,146,1,0,1,148
06/30/1999,1,142,3,0,1,147
07/31/1999,0,144,2,0,2,148
08/31/1999,1,146,1,1,2,151
09/30/1999,0,149,1,0,1,151
10/31/1999,1,147,3,0,0,151
11/30/1999,1,150,1,1,0,153
12/31/1999,1,150,1,0,0,152
01/31/2000,1,147,2,1,3,154
02/29/2000,3,148,0,1,0,152
03/31/2000,1,148,3,0,1,153
04/30/2000,0,151,0,2,0,153
05/31/2000,2,147,2,0,2,153
06/30/2000,1,150,0,1,1,153
07/31/2000,0,153,0,0,1,154
08/31/2000,1,149,2,0,2,154
09/30/2000,0,152,1,0,2,155
10/31/2000,1,151,2,1,0,155
11/30/2000,0,154,1,1,3,159
12/31/2000,0,155,2,0,2,159
01/31/2001,0,157,0,0,1,158
02/28/2001,1,156,1,0,1,159
03/31/2001,0,158,3,0,0,161
04/30/2001,0,158,1,1,1,161
05/31/2001,0,155,4,0,0,159
06/30/2001,0,159,1,0,2,162
07/31/2001,0,156,3,1,0,160
08/31/2001,0,153,5,0,2,160
09/30/2001,0,153,2,3,1,159
10/31/2001,0,145,8,1,2,156
11/30/2001,1,148,5,1,1,156
12/31/2001,0,150,2,2,2,156
01/31/2002,0,149,1,1,5,156
02/28/2002,0,152,2,1,2,157
03/31/2002,1,146,4,0,3,154
04/30/2002,2,148,4,0,0,154
05/31/2002,1,152,1,0,1,155
06/30/2002,0,154,0,1,2,157
07/31/2002,0,154,2,0,0,156
08/31/2002,0,156,1,1,0,158
09/30/2002,0,156,2,0,1,159
10/31/2002,1,155,1,0,3,160
11/30/2002,1,150,2,0,5,158
12/31/2002,1,148,5,0,1,155
01/31/2003,1,158,0,0,0,159
02/28/2003,0,158,0,0,1,159
03/31/2003,0,153,0,2,4,159
04/30/2003,0,151,1,0,1,153
05/31/2003,1,146,2,1,3,153
06/30/2003,0,147,1,0,1,149
07/31/2003,1,150,0,0,0,151
08/31/2003,0,149,0,0,2,151
09/30/2003,0,148,0,0,1,149
10/31/2003,0,150,1,0,1,152
11/30/2003,1,156,1,0,2,160
12/31/2003,0,158,0,0,4,162
01/31/2004,0,157,0,0,2,159
02/29/2004,0,157,0,0,1,158
03/31/2004,1,155,3,0,1,160
04/30/2004,1,161,1,0,0,163
05/31/2004,0,166,0,0,0,166
06/30/2004,0,168,0,0,0,168
07/31/2004,0,170,0,0,1,171
08/31/2004,0,172,2,0,0,174
09/30/2004,0,174,0,0,1,175
10/31/2004,2,173,0,0,1,176
11/30/2004,0,176,0,0,1,177
12/31/2004,0,171,1,0,4,176
01/31/2005,3,169,2,0,2,176
02/28/2005,1,173,1,0,1,176
03/31/2005,3,169,0,0,5,177
04/30/2005,0,173,1,0,0,174
05/31/2005,0,175,0,0,2,177
06/30/2005,1,174,0,0,1,176
07/31/2005,0,172,1,0,2,175
08/31/2005,1,171,0,0,3,175
09/30/2005,0,170,0,0,3,173
10/31/2005,0,172,0,0,0,172
11/30/2005,1,171,1,0,1,174
12/31/2005,1,172,0,0,3,176
01/31/2006,0,172,1,0,1,174
02/28/2006,2,169,1,0,1,173
03/31/2006,0,173,2,0,1,176
04/30/2006,1,177,0,0,1,179
05/31/2006,0,180,0,1,0,181
06/30/2006,1,176,0,0,5,182
07/31/2006,0,179,1,0,0,180
08/31/2006,2,178,0,0,2,182
09/30/2006,0,177,4,0,1,182
10/31/2006,0,183,0,0,1,184
11/30/2006,2,186,0,0,0,188
12/31/2006,2,189,0,0,0,191
01/31/2007,1,182,0,0,9,192
02/28/2007,1,182,2,0,1,186
03/31/2007,2,180,0,0,3,185
04/30/2007,2,177,1,0,4,184
05/31/2007,2,177,0,0,4,183
06/30/2007,2,179,1,0,2,184
07/31/2007,0,185,0,0,0,185
08/31/2007,0,187,0,0,0,187
09/30/2007,1,184,1,0,1,187
10/31/2007,0,188,1,0,0,189
11/30/2007,1,188,2,0,0,191
12/31/2007,1,190,0,0,3,194
01/31/2008,2,189,1,0,1,193
02/29/2008,1,191,0,0,0,192
03/31/2008,1,186,2,0,3,192
04/30/2008,0,188,0,0,2,190
05/31/2008,0,188,0,0,1,189
06/30/2008,1,186,1,0,1,189
07/31/2008,1,181,3,0,4,189
08/31/2008,0,184,1,0,2,187
09/30/2008,0,183,0,0,2,185
10/31/2008,2,181,2,0,0,185
11/30/2008,1,181,2,0,1,185
12/31/2008,2,170,5,1,6,184
01/31/2009,0,176,3,1,0,180
02/28/2009,1,172,6,0,0,179
03/31/2009,0,171,5,1,2,179
04/30/2009,0,171,3,1,3,178
05/31/2009,0,171,2,1,1,175
06/30/2009,0,169,4,0,1,174
07/31/2009,3,169,0,1,0,173
08/31/2009,1,171,0,1,0,173
09/30/2009,1,172,0,0,0,173
10/31/2009,2,171,0,0,1,174
11/30/2009,1,172,1,0,0,174
12/31/2009,2,171,0,0,1,174
01/31/2010,0,171,2,0,1,174
02/28/2010,0,173,0,0,1,174
03/31/2010,2,171,0,0,0,173
04/30/2010,2,173,0,0,0,175
05/31/2010,1,178,1,0,0,180
06/30/2010,1,179,0,0,3,183
07/31/2010,0,181,0,0,3,184
08/31/2010,0,182,2,0,1,185
09/30/2010,1,183,0,0,1,185
10/31/2010,1,185,0,0,0,186
11/30/2010,0,189,1,0,0,190
12/31/2010,1,189,0,0,3,193
01/31/2011,1,190,1,0,1,193
02/28/2011,1,191,0,0,1,193
03/31/2011,2,192,0,0,0,194
04/30/2011,2,195,0,0,0,197
05/31/2011,1,198,0,0,0,199
06/30/2011,2,195,2,0,3,202
07/31/2011,2,195,1,0,4,202
08/31/2011,2,201,2,0,0,205
09/30/2011,0,203,0,0,3,206
10/31/2011,1,200,1,0,3,205
11/30/2011,1,201,2,0,0,204
12/31/2011,1,203,1,0,2,207
01/31/2012,1,204,0,0,2,207
02/29/2012,1,203,2,0,2,208
03/31/2012,1,208,0,0,2,211
04/30/2012,2,204,1,0,3,210
05/31/2012,2,203,1,0,2,208
06/30/2012,0,207,0,0,1,208
07/31/2012,0,210,0,0,1,211
08/31/2012,0,208,3,0,3,214
09/30/2012,0,213,2,0,0,215
10/31/2012,0,217,0,0,0,217
11/30/2012,0,217,1,1,0,219
12/31/2012,1,216,2,0,1,220
01/31/2013,1,218,1,0,4,224
02/28/2013,1,220,1,0,0,222
03/31/2013,0,221,2,0,1,224
04/30/2013,2,222,1,0,0,225
05/31/2013,1,229,1,0,0,231
06/30/2013,1,229,2,0,2,234
07/31/2013,0,230,3,0,2,235
08/31/2013,2,232,0,0,1,235
09/30/2013,1,230,3,0,1,235
10/31/2013,3,230,2,0,2,237
11/30/2013,0,236,1,0,3,240
12/31/2013,8,229,1,0,2,240
01/31/2014,0,234,0,0,7,241
02/28/2014,0,234,0,1,0,235
03/31/2014,2,233,2,0,2,239
04/30/2014,0,241,0,0,2,243
05/31/2014,1,245,0,1,2,249
06/30/2014,0,248,1,0,6,255
07/31/2014,0,253,0,0,2,255
08/31/2014,1,252,1,0,1,255
09/30/2014,0,251,0,0,4,255
10/31/2014,1,257,1,0,0,259
11/30/2014,0,261,0,0,3,264
12/31/2014,0,264,0,1,0,265
01/31/2015,0,265,0,0,3,268
02/28/2015,0,265,1,0,2,268
03/31/2015,0,264,1,0,2,267
04/30/2015,2,263,4,0,0,269
05/31/2015,2,266,1,0,4,273
06/30/2015,0,259,3,2,9,273
07/31/2015,0,268,1,0,1,270
08/31/2015,0,268,1,0,1,270
09/30/2015,0,266,3,0,0,269
10/31/2015,1,268,4,0,3,276
11/30/2015,0,268,2,1,3,274
12/31/2015,1,267,1,0,5,274
01/31/2016,0,267,1,0,2,270
02/29/2016,1,265,2,0,2,270
03/31/2016,2,265,1,1,1,270
04/30/2016,2,265,1,0,2,270
05/31/2016,0,268,1,1,0,270
06/30/2016,0,271,0,0,3,274
07/31/2016,0,272,1,0,1,274
08/31/2016,2,267,3,0,3,275
09/30/2016,1,269,0,0,4,274
10/31/2016,1,271,0,0,6,278
11/30/2016,0,273,2,0,1,276
12/31/2016,1,274,1,0,4,280
01/31/2017,2,268,2,1,5,278
02/28/2017,0,273,1,0,2,276
03/31/2017,2,272,0,0,2,276
04/30/2017,0,274,2,1,2,279
05/31/2017,0,276,2,0,1,279
06/30/2017,1,276,1,0,3,281
07/31/2017,1,274,2,0,2,279
08/31/2017,0,276,0,1,5,282
09/30/2017,0,276,0,0,3,279
10/31/2017,0,275,1,1,6,283
11/30/2017,0,278,2,0,2,282
12/31/2017,0,282,0,0,2,284
01/31/2018,1,283,0,0,2,286
02/28/2018,0,285,2,0,2,289
03/31/2018,0,285,2,0,3,290
04/30/2018,0,289,0,0,2,291
05/31/2018,1,289,1,1,2,294
06/30/2018,1,292,1,0,3,297
07/31/2018,0,292,1,0,7,300
08/31/2018,1,292,2,0,4,299
09/30/2018,1,294,3,0,1,299
10/31/2018,0,300,0,0,3,303
11/30/2018,0,300,0,1,4,305
12/31/2018,0,302,1,0,0,303
01/31/2019,0,301,0,0,4,305
02/28/2019,0,304,0,0,0,304
03/31/2019,0,303,1,0,2,306
04/30/2019,0,304,1,2,4,311
05/31/2019,1,303,2,0,4,310
06/30/2019,0,311,0,0,1,312
07/31/2019,0,309,2,0,6,317
08/31/2019,0,309,2,0,3,314
09/30/2019,1,305,2,0,4,312
10/31/2019,1,307,1,0,4,313
11/30/2019,2,306,1,0,5,314
12/31/2019,1,307,0,1,3,312
01/31/2020,0,307,0,0,2,309
02/29/2020,0,305,1,1,2,309
03/31/2020,1,302,4,1,2,310
04/30/2020,0,297,6,1,5,309
05/31/2020,1,304,1,1,1,308
06/30/2020,0,300,1,0,6,307
07/31/2020,1,301,2,0,1,305
08/31/2020,0,300,1,0,5,306
09/30/2020,1,300,0,1,2,304
10/31/2020,0,301,0,0,4,305
11/30/2020,1,303,0,0,3,307
12/31/2020,0,303,1,2,2,308
01/31/2021,0,307,0,1,2,310
02/28/2021,3,308,0,0,2,313
03/31/2021,0,313,0,0,2,315
04/30/2021,1,317,1,0,2,321
05/31/2021,3,326,0,0,0,329
06/30/2021,2,322,1,0,7,332
07/31/2021,2,323,2,0,8,335
08/31/2021,1,328,0,0,2,331
09/30/2021,5,324,0,0,3,332
