Up/Down,Upgrade,Same,Downgrade,Defaulted,Non-Rated,Totals
01/31/1981,1,38,4,0,0,43
02/28/1981,0,44,1,0,0,45
03/31/1981,0,45,0,0,0,45
04/30/1981,0,45,1,0,0,46
05/31/1981,1,45,0,0,0,46
06/30/1981,1,44,0,0,1,46
07/31/1981,0,45,0,0,0,45
08/31/1981,0,45,0,0,0,45
09/30/1981,0,44,1,0,0,45
10/31/1981,0,45,0,0,0,45
11/30/1981,0,46,0,0,0,46
12/31/1981,1,45,0,0,0,46
01/31/1982,1,43,2,0,0,46
02/28/1982,0,46,1,0,0,47
03/31/1982,0,46,0,1,0,47
04/30/1982,1,43,1,0,1,46
05/31/1982,0,45,0,0,0,45
06/30/1982,1,44,0,0,0,45
07/31/1982,0,46,0,0,0,46
08/31/1982,0,45,2,0,0,47
09/30/1982,0,48,0,0,0,48
10/31/1982,0,50,0,0,0,50
11/30/1982,0,52,0,0,0,52
12/31/1982,0,51,0,0,1,52
01/31/1983,0,53,0,0,1,54
02/28/1983,0,53,0,0,0,53
03/31/1983,0,52,0,0,1,53
04/30/1983,0,55,0,0,0,55
05/31/1983,1,56,0,0,1,58
06/30/1983,2,58,0,0,0,60
07/31/1983,0,61,2,0,0,63
08/31/1983,0,64,0,0,0,64
09/30/1983,0,62,1,0,1,64
10/31/1983,0,63,1,0,0,64
11/30/1983,0,64,0,0,0,64
12/31/1983,0,62,1,0,1,64
01/31/1984,1,61,2,0,0,64
02/29/1984,0,64,0,0,0,64
03/31/1984,0,65,0,0,0,65
04/30/1984,1,64,0,0,0,65
05/31/1984,0,64,1,0,0,65
06/30/1984,1,65,1,0,0,67
07/31/1984,0,67,1,0,0,68
08/31/1984,0,70,0,0,0,70
09/30/1984,0,71,0,0,0,71
10/31/1984,0,72,0,0,0,72
11/30/1984,0,78,0,0,0,78
12/31/1984,0,80,0,0,0,80
01/31/1985,1,77,1,0,1,80
02/28/1985,1,83,0,0,0,84
03/31/1985,0,86,0,0,0,86
04/30/1985,2,84,0,0,0,86
05/31/1985,0,87,0,0,1,88
06/30/1985,0,88,1,0,0,89
07/31/1985,0,88,2,0,0,90
08/31/1985,0,92,0,0,1,93
09/30/1985,0,94,0,0,0,94
10/31/1985,0,91,3,0,1,95
11/30/1985,1,93,1,2,0,97
12/31/1985,0,99,1,0,0,100
01/31/1986,0,102,1,0,1,104
02/28/1986,0,103,0,0,0,103
03/31/1986,2,102,1,0,0,105
04/30/1986,0,109,2,0,0,111
05/31/1986,0,115,0,0,0,115
06/30/1986,0,115,4,1,1,121
07/31/1986,1,116,1,0,4,122
08/31/1986,0,118,0,0,3,121
09/30/1986,0,125,0,0,0,125
10/31/1986,0,127,0,0,0,127
11/30/1986,1,131,0,0,1,133
12/31/1986,0,135,1,0,1,137
01/31/1987,0,135,1,0,3,139
02/28/1987,0,133,2,0,1,136
03/31/1987,0,140,0,0,1,141
04/30/1987,1,138,2,0,1,142
05/31/1987,0,143,0,0,4,147
06/30/1987,0,145,1,0,2,148
07/31/1987,1,146,2,0,1,150
08/31/1987,0,154,1,0,0,155
09/30/1987,1,155,0,0,2,158
10/31/1987,0,158,0,0,0,158
11/30/1987,2,154,1,1,3,161
12/31/1987,1,156,0,0,1,158
01/31/1988,1,150,2,0,4,157
02/29/1988,0,150,2,0,3,155
03/31/1988,1,149,2,1,1,154
04/30/1988,0,151,1,0,1,153
05/31/1988,2,151,0,1,0,154
06/30/1988,2,148,0,2,1,153
07/31/1988,0,150,0,0,1,151
08/31/1988,0,151,1,0,0,152
09/30/1988,0,151,1,0,1,153
10/31/1988,0,152,0,0,0,152
11/30/1988,0,151,1,1,3,156
12/31/1988,0,146,3,0,4,153
01/31/1989,2,145,2,0,0,149
02/28/1989,0,146,0,0,3,149
03/31/1989,1,145,0,0,0,146
04/30/1989,0,144,1,1,2,148
05/31/1989,0,145,1,0,1,147
06/30/1989,1,140,2,0,4,147
07/31/1989,0,137,2,1,4,144
08/31/1989,0,135,4,1,0,140
09/30/1989,3,132,3,0,2,140
10/31/1989,3,131,1,3,1,139
11/30/1989,3,130,0,2,1,136
12/31/1989,0,132,0,2,1,135
01/31/1990,0,128,1,0,4,133
02/28/1990,0,128,0,2,1,131
03/31/1990,2,123,1,0,3,129
04/30/1990,0,125,1,0,0,126
05/31/1990,0,123,1,0,3,127
06/30/1990,0,123,1,0,2,126
07/31/1990,0,120,2,2,0,124
08/31/1990,1,117,2,1,1,122
09/30/1990,0,117,1,2,0,120
10/31/1990,0,109,9,1,1,120
11/30/1990,0,113,3,2,0,118
12/31/1990,0,113,4,2,0,119
01/31/1991,0,114,0,3,0,117
02/28/1991,1,112,2,0,0,115
03/31/1991,1,113,0,0,2,116
04/30/1991,0,113,1,0,0,114
05/31/1991,1,110,1,0,2,114
06/30/1991,0,112,0,1,0,113
07/31/1991,0,110,1,1,0,112
08/31/1991,1,109,0,1,1,112
09/30/1991,0,110,0,0,0,110
10/31/1991,0,109,1,0,0,110
11/30/1991,0,108,0,1,1,110
12/31/1991,3,103,0,1,2,109
01/31/1992,5,100,0,1,1,107
02/29/1992,0,104,1,0,0,105
03/31/1992,2,104,1,0,1,108
04/30/1992,1,104,0,0,2,107
05/31/1992,2,107,0,1,1,111
06/30/1992,3,107,2,0,0,112
07/31/1992,2,109,1,0,2,114
08/31/1992,0,110,0,0,2,112
09/30/1992,0,111,0,0,1,112
10/31/1992,2,112,0,0,2,116
11/30/1992,2,116,0,0,1,119
12/31/1992,1,118,1,0,2,122
01/31/1993,4,113,0,0,4,121
02/28/1993,1,119,0,0,0,120
03/31/1993,1,111,3,0,5,120
04/30/1993,1,113,0,1,2,117
05/31/1993,0,117,1,0,0,118
06/30/1993,0,120,0,0,1,121
07/31/1993,1,118,0,0,4,123
08/31/1993,2,120,0,0,0,122
09/30/1993,0,123,0,0,1,124
10/31/1993,1,122,0,0,3,126
11/30/1993,0,128,1,0,0,129
12/31/1993,3,126,2,0,4,135
01/31/1994,0,133,0,0,1,134
02/28/1994,1,134,0,2,2,139
03/31/1994,1,137,0,1,1,140
04/30/1994,1,140,0,0,0,141
05/31/1994,0,141,0,0,2,143
06/30/1994,1,144,1,0,0,146
07/31/1994,0,149,0,0,1,150
08/31/1994,0,151,0,0,3,154
09/30/1994,4,151,0,0,1,156
10/31/1994,0,159,0,0,0,159
11/30/1994,0,162,0,0,0,162
12/31/1994,3,158,1,0,1,163
01/31/1995,0,162,1,0,0,163
02/28/1995,1,163,0,0,0,164
03/31/1995,0,164,1,0,1,166
04/30/1995,1,167,0,0,1,169
05/31/1995,1,166,2,0,2,171
06/30/1995,2,168,2,1,0,173
07/31/1995,0,173,1,0,0,174
08/31/1995,0,177,1,0,0,178
09/30/1995,0,180,0,1,0,181
10/31/1995,1,179,3,0,2,185
11/30/1995,1,183,1,1,1,187
12/31/1995,1,184,4,0,0,189
01/31/1996,2,186,3,0,1,192
02/29/1996,0,192,3,0,1,196
03/31/1996,1,195,1,1,1,199
04/30/1996,2,199,0,0,1,202
05/31/1996,0,205,2,0,4,211
06/30/1996,1,209,0,0,0,210
07/31/1996,2,209,0,0,3,214
08/31/1996,2,205,3,0,3,213
09/30/1996,0,210,0,0,3,213
10/31/1996,4,209,2,0,0,215
11/30/1996,1,213,2,1,3,220
12/31/1996,0,213,2,1,4,220
01/31/1997,1,216,0,0,1,218
02/28/1997,0,218,1,0,5,224
03/31/1997,1,217,1,0,2,221
04/30/1997,4,221,0,0,1,226
05/31/1997,0,226,1,0,0,227
06/30/1997,0,229,0,0,3,232
07/31/1997,2,235,0,0,0,237
08/31/1997,1,244,0,0,2,247
09/30/1997,0,255,0,0,1,256
10/31/1997,1,258,0,0,3,262
11/30/1997,1,261,3,1,3,269
12/31/1997,1,264,2,0,3,270
01/31/1998,0,272,1,4,1,278
02/28/1998,2,274,0,0,4,280
03/31/1998,0,282,2,0,1,285
04/30/1998,1,287,4,1,0,293
05/31/1998,1,293,3,0,3,300
06/30/1998,2,303,0,0,4,309
07/31/1998,2,306,3,1,5,317
08/31/1998,1,315,2,0,2,320
09/30/1998,1,319,1,1,1,323
10/31/1998,2,311,4,0,4,321
11/30/1998,0,313,5,1,2,321
12/31/1998,4,314,2,0,0,320
01/31/1999,1,316,5,0,2,324
02/28/1999,2,315,5,2,2,326
03/31/1999,2,319,0,1,6,328
04/30/1999,1,327,3,0,0,331
05/31/1999,0,322,7,2,3,334
06/30/1999,0,324,3,5,2,334
07/31/1999,1,321,1,3,7,333
08/31/1999,0,320,3,2,4,329
09/30/1999,0,321,2,0,2,325
10/31/1999,2,324,2,2,2,332
11/30/1999,0,329,2,0,1,332
12/31/1999,4,327,1,0,3,335
01/31/2000,0,329,2,0,1,332
02/29/2000,1,329,1,0,0,331
03/31/2000,0,327,3,1,3,334
04/30/2000,1,323,2,4,2,332
05/31/2000,1,315,3,1,6,326
06/30/2000,1,317,0,1,1,320
07/31/2000,1,315,0,0,3,319
08/31/2000,1,300,10,1,5,317
09/30/2000,1,302,4,3,2,312
10/31/2000,1,303,3,1,0,308
11/30/2000,0,305,5,0,1,311
12/31/2000,0,310,1,2,1,314
01/31/2001,3,301,5,1,3,313
02/28/2001,4,302,3,1,0,310
03/31/2001,0,308,5,0,0,313
04/30/2001,1,309,2,1,2,315
05/31/2001,1,299,2,2,9,313
06/30/2001,1,295,5,1,4,306
07/31/2001,0,301,1,1,0,303
08/31/2001,0,295,7,2,2,306
09/30/2001,0,295,7,1,0,303
10/31/2001,2,291,5,2,3,303
11/30/2001,0,287,8,1,3,299
12/31/2001,0,284,8,2,2,296
01/31/2002,0,287,6,2,3,298
02/28/2002,3,285,2,2,3,295
03/31/2002,1,287,5,1,0,294
04/30/2002,0,287,6,1,5,299
05/31/2002,2,290,0,1,2,295
06/30/2002,0,285,1,2,6,294
07/31/2002,1,287,1,1,1,291
08/31/2002,0,277,8,0,4,289
09/30/2002,1,280,1,2,2,286
10/31/2002,0,275,6,1,1,283
11/30/2002,1,273,2,2,4,282
12/31/2002,2,271,2,2,0,277
01/31/2003,1,268,4,1,2,276
02/28/2003,1,264,7,0,3,275
03/31/2003,1,266,3,0,3,273
04/30/2003,0,272,2,0,2,276
05/31/2003,0,271,2,0,4,277
06/30/2003,1,276,0,0,1,278
07/31/2003,1,271,2,1,4,279
08/31/2003,0,273,1,1,1,276
09/30/2003,2,269,2,0,4,277
10/31/2003,1,268,3,0,3,275
11/30/2003,2,278,1,0,1,282
12/31/2003,2,282,1,0,1,286
01/31/2004,0,286,2,0,0,288
02/29/2004,0,290,1,0,0,291
03/31/2004,0,293,0,0,2,295
04/30/2004,1,297,1,0,2,301
05/31/2004,0,299,0,0,4,303
06/30/2004,2,294,1,1,3,301
07/31/2004,2,292,0,0,4,298
08/31/2004,1,294,1,0,1,297
09/30/2004,1,297,1,0,1,300
10/31/2004,0,294,0,0,7,301
11/30/2004,0,293,1,2,0,296
12/31/2004,1,284,2,0,9,296
01/31/2005,0,288,0,0,2,290
02/28/2005,3,282,4,0,1,290
03/31/2005,2,285,1,0,3,291
04/30/2005,0,286,2,0,3,291
05/31/2005,1,286,1,0,3,291
06/30/2005,2,285,3,0,3,293
07/31/2005,1,290,1,0,1,293
08/31/2005,2,292,0,0,2,296
09/30/2005,0,290,2,1,2,295
10/31/2005,1,291,1,1,3,297
11/30/2005,1,295,2,0,1,299
12/31/2005,0,303,0,0,0,303
01/31/2006,1,297,3,0,7,308
02/28/2006,0,301,3,0,1,305
03/31/2006,1,301,3,0,1,306
04/30/2006,2,307,0,0,1,310
05/31/2006,1,304,3,0,4,312
06/30/2006,0,306,4,1,4,315
07/31/2006,1,312,0,0,1,314
08/31/2006,0,313,2,0,2,317
09/30/2006,2,308,4,1,2,317
10/31/2006,2,308,2,0,5,317
11/30/2006,0,316,4,0,1,321
12/31/2006,0,311,7,0,6,324
01/31/2007,0,312,0,0,8,320
02/28/2007,0,309,4,0,4,317
03/31/2007,0,312,1,0,3,316
04/30/2007,2,309,4,1,0,316
05/31/2007,1,314,1,0,4,320
06/30/2007,0,317,2,0,3,322
07/31/2007,0,321,3,0,0,324
08/31/2007,1,328,3,0,1,333
09/30/2007,1,327,0,0,6,334
10/31/2007,1,323,2,0,2,328
11/30/2007,0,318,6,1,5,330
12/31/2007,2,316,4,0,5,327
01/31/2008,0,318,4,1,0,323
02/29/2008,0,315,4,0,3,322
03/31/2008,1,312,2,1,3,319
04/30/2008,0,304,4,3,5,316
05/31/2008,0,306,6,3,0,315
06/30/2008,0,307,3,1,1,312
07/31/2008,2,300,5,1,5,313
08/31/2008,2,304,5,0,5,316
09/30/2008,0,307,3,1,2,313
10/31/2008,0,301,8,1,0,310
11/30/2008,0,293,12,3,1,309
12/31/2008,1,289,10,6,1,307
01/31/2009,0,291,6,4,1,302
02/28/2009,0,280,16,2,0,298
03/31/2009,0,274,16,5,2,297
04/30/2009,1,265,12,11,5,294
05/31/2009,0,266,7,8,3,284
06/30/2009,1,255,8,5,7,276
07/31/2009,0,266,3,1,1,271
08/31/2009,1,267,2,6,2,278
09/30/2009,0,268,5,2,0,275
10/31/2009,1,268,4,2,0,275
11/30/2009,1,277,2,3,0,283
12/31/2009,1,276,2,2,1,282
01/31/2010,2,275,2,2,1,282
02/28/2010,2,282,0,1,0,285
03/31/2010,0,283,1,0,1,285
04/30/2010,4,276,2,2,3,287
05/31/2010,6,274,2,0,3,285
06/30/2010,2,280,1,4,1,288
07/31/2010,1,287,0,0,3,291
08/31/2010,0,288,1,2,1,292
09/30/2010,2,289,1,1,0,293
10/31/2010,1,291,0,0,1,293
11/30/2010,1,286,3,2,2,294
12/31/2010,4,291,2,1,1,299
01/31/2011,2,295,2,1,2,302
02/28/2011,7,295,1,0,1,304
03/31/2011,3,295,3,0,4,305
04/30/2011,5,296,1,1,4,307
05/31/2011,2,299,2,1,2,306
06/30/2011,2,298,2,0,4,306
07/31/2011,0,310,0,0,2,312
08/31/2011,0,310,4,0,2,316
09/30/2011,0,309,4,0,5,318
10/31/2011,0,311,2,0,2,315
11/30/2011,3,302,6,3,1,315
12/31/2011,1,304,2,1,4,312
01/31/2012,1,303,1,4,0,309
02/29/2012,2,303,1,0,3,309
03/31/2012,2,300,1,3,2,308
04/30/2012,1,301,2,0,3,307
05/31/2012,0,300,5,0,0,305
06/30/2012,2,300,1,2,3,308
07/31/2012,0,298,4,0,2,304
08/31/2012,0,299,2,0,3,304
09/30/2012,0,297,3,0,1,301
10/31/2012,3,300,0,3,1,307
11/30/2012,0,303,4,0,1,308
12/31/2012,1,302,4,1,3,311
01/31/2013,0,302,3,3,3,311
02/28/2013,1,303,0,3,1,308
03/31/2013,2,298,1,3,5,309
04/30/2013,0,304,0,0,4,308
05/31/2013,2,299,6,0,0,307
06/30/2013,4,306,1,1,1,313
07/31/2013,0,314,1,1,1,317
08/31/2013,2,313,1,2,1,319
09/30/2013,1,320,2,0,0,323
10/31/2013,1,325,1,1,4,332
11/30/2013,0,329,2,1,0,332
12/31/2013,3,328,1,2,2,336
01/31/2014,3,334,0,0,4,341
02/28/2014,2,337,1,0,4,344
03/31/2014,1,341,0,1,4,347
04/30/2014,2,348,2,0,1,353
05/31/2014,1,352,3,0,4,360
06/30/2014,0,357,0,1,4,362
07/31/2014,1,363,0,1,2,367
08/31/2014,0,364,4,1,4,373
09/30/2014,1,366,3,2,0,372
10/31/2014,0,373,0,1,2,376
11/30/2014,0,367,2,1,5,375
12/31/2014,2,364,3,2,4,375
01/31/2015,1,366,1,1,4,373
02/28/2015,0,368,1,0,1,370
03/31/2015,2,363,3,0,3,371
04/30/2015,1,366,3,0,2,372
05/31/2015,1,371,0,1,2,375
06/30/2015,1,371,0,0,2,374
07/31/2015,1,371,2,1,2,377
08/31/2015,0,379,1,0,1,381
09/30/2015,0,376,1,0,3,380
10/31/2015,2,374,2,1,1,380
11/30/2015,0,378,3,1,2,384
12/31/2015,0,380,2,1,2,385
01/31/2016,1,379,1,0,3,384
02/29/2016,1,378,0,1,2,382
03/31/2016,0,376,3,2,1,382
04/30/2016,3,375,0,0,2,380
05/31/2016,4,372,1,1,3,381
06/30/2016,2,373,2,1,1,379
07/31/2016,0,372,4,0,2,378
08/31/2016,2,373,2,0,3,380
09/30/2016,0,374,2,0,2,378
10/31/2016,3,378,1,1,4,387
11/30/2016,2,376,1,0,5,384
12/31/2016,1,372,2,2,6,383
01/31/2017,0,373,0,0,4,377
02/28/2017,0,376,0,1,2,379
03/31/2017,2,369,3,0,4,378
04/30/2017,0,371,3,1,2,377
05/31/2017,3,363,5,1,3,375
06/30/2017,0,368,1,1,6,376
07/31/2017,1,363,1,0,5,370
08/31/2017,0,362,1,0,5,368
09/30/2017,2,357,2,0,5,366
10/31/2017,0,362,4,0,1,367
11/30/2017,0,360,1,1,4,366
12/31/2017,0,361,2,0,4,367
01/31/2018,1,358,1,0,6,366
02/28/2018,0,362,2,3,2,369
03/31/2018,1,359,3,0,2,365
04/30/2018,1,368,2,0,1,372
05/31/2018,0,370,2,1,1,374
06/30/2018,0,366,3,0,6,375
07/31/2018,0,374,2,0,0,376
08/31/2018,2,373,1,0,4,380
09/30/2018,0,380,0,0,1,381
10/31/2018,1,377,0,0,5,383
11/30/2018,1,372,1,2,6,382
12/31/2018,1,372,0,1,4,378
01/31/2019,0,368,2,0,4,374
02/28/2019,1,367,0,1,5,374
03/31/2019,2,358,4,1,3,368
04/30/2019,1,358,2,0,5,366
05/31/2019,1,356,3,1,3,364
06/30/2019,1,356,2,1,2,362
07/31/2019,1,356,2,0,3,362
08/31/2019,1,355,3,0,3,362
09/30/2019,1,354,2,1,4,362
10/31/2019,0,358,2,1,1,362
11/30/2019,0,356,5,0,2,363
12/31/2019,0,355,2,0,7,364
01/31/2020,0,359,1,0,5,365
02/29/2020,0,362,1,1,1,365
03/31/2020,0,329,34,0,0,363
04/30/2020,0,331,23,4,5,363
05/31/2020,0,336,14,3,3,356
06/30/2020,0,343,8,2,1,354
07/31/2020,1,340,7,2,2,352
08/31/2020,0,344,5,2,1,352
09/30/2020,0,344,7,1,2,354
10/31/2020,0,351,2,1,0,354
11/30/2020,0,345,7,1,2,355
12/31/2020,5,351,2,1,0,359
01/31/2021,1,349,2,3,5,360
02/28/2021,5,352,0,0,1,358
03/31/2021,4,350,4,0,3,361
04/30/2021,4,358,0,1,1,364
05/31/2021,0,365,0,0,2,367
06/30/2021,0,364,1,1,3,369
07/31/2021,0,368,0,1,3,372
08/31/2021,3,365,3,0,3,374
09/30/2021,1,373,1,0,3,378
