Up/Down,Upgrade,Same,Downgrade,Defaulted,Non-Rated,Totals
01/31/1981,0,93,1,0,0,94
02/28/1981,3,91,0,1,0,95
03/31/1981,0,94,0,0,0,94
04/30/1981,1,93,0,0,0,94
05/31/1981,0,95,0,0,0,95
06/30/1981,1,93,1,0,0,95
07/31/1981,1,94,0,0,0,95
08/31/1981,0,94,1,0,0,95
09/30/1981,0,94,1,0,0,95
10/31/1981,0,94,0,1,0,95
11/30/1981,0,94,0,0,0,94
12/31/1981,0,92,2,0,0,94
01/31/1982,0,94,0,0,0,94
02/28/1982,0,94,0,0,0,94
03/31/1982,0,94,0,0,0,94
04/30/1982,0,93,0,1,0,94
05/31/1982,2,88,1,1,1,93
06/30/1982,0,91,1,0,1,93
07/31/1982,0,91,1,0,0,92
08/31/1982,0,89,3,0,0,92
09/30/1982,0,94,1,0,0,95
10/31/1982,0,95,0,0,0,95
11/30/1982,0,96,0,0,0,96
12/31/1982,1,94,1,0,0,96
01/31/1983,1,95,0,0,0,96
02/28/1983,0,95,2,0,0,97
03/31/1983,0,98,0,0,0,98
04/30/1983,0,98,0,0,1,99
05/31/1983,2,96,0,0,1,99
06/30/1983,0,98,1,0,0,99
07/31/1983,0,99,0,0,0,99
08/31/1983,1,100,0,0,0,101
09/30/1983,4,95,1,1,0,101
10/31/1983,0,100,0,0,0,100
11/30/1983,1,98,0,0,1,100
12/31/1983,0,99,0,0,0,99
01/31/1984,0,97,1,0,1,99
02/29/1984,0,98,0,0,0,98
03/31/1984,0,97,0,0,1,98
04/30/1984,1,95,1,0,0,97
05/31/1984,0,96,0,1,0,97
06/30/1984,2,94,0,0,0,96
07/31/1984,5,92,0,0,0,97
08/31/1984,0,97,0,0,0,97
09/30/1984,0,95,1,1,0,97
10/31/1984,0,96,0,0,0,96
11/30/1984,0,96,0,0,0,96
12/31/1984,0,95,1,1,1,98
01/31/1985,4,89,1,0,2,96
02/28/1985,0,102,0,0,1,103
03/31/1985,1,101,0,0,0,102
04/30/1985,0,102,0,0,0,102
05/31/1985,0,101,2,0,0,103
06/30/1985,1,103,0,0,0,104
07/31/1985,0,105,0,0,0,105
08/31/1985,2,103,0,0,0,105
09/30/1985,0,104,0,0,1,105
10/31/1985,0,108,0,0,0,108
11/30/1985,1,108,0,0,0,109
12/31/1985,0,109,0,0,1,110
01/31/1986,0,112,0,0,0,112
02/28/1986,0,113,0,0,1,114
03/31/1986,1,110,1,0,1,113
04/30/1986,0,112,1,0,1,114
05/31/1986,0,112,3,0,0,115
06/30/1986,0,116,0,0,0,116
07/31/1986,0,114,2,1,0,117
08/31/1986,0,118,0,0,1,119
09/30/1986,0,117,0,0,1,118
10/31/1986,0,116,2,0,0,118
11/30/1986,0,118,0,0,0,118
12/31/1986,0,118,1,0,0,119
01/31/1987,0,118,0,0,1,119
02/28/1987,1,117,0,0,0,118
03/31/1987,0,113,4,0,1,118
04/30/1987,0,117,0,0,0,117
05/31/1987,0,117,0,0,0,117
06/30/1987,0,115,1,0,2,118
07/31/1987,0,118,0,0,0,118
08/31/1987,1,116,1,0,1,119
09/30/1987,0,119,0,0,0,119
10/31/1987,1,118,0,0,1,120
11/30/1987,0,118,2,0,0,120
12/31/1987,0,118,0,0,2,120
01/31/1988,0,117,0,0,1,118
02/29/1988,0,113,4,0,0,117
03/31/1988,0,116,0,0,2,118
04/30/1988,1,114,1,0,0,116
05/31/1988,0,112,5,0,0,117
06/30/1988,0,113,4,0,1,118
07/31/1988,0,116,0,0,1,117
08/31/1988,1,114,1,0,0,116
09/30/1988,0,114,0,0,2,116
10/31/1988,0,108,6,0,1,115
11/30/1988,0,112,3,0,0,115
12/31/1988,1,111,2,0,1,115
01/31/1989,0,111,2,0,1,114
02/28/1989,0,112,0,0,1,113
03/31/1989,2,107,2,1,0,112
04/30/1989,2,110,0,0,0,112
05/31/1989,0,107,5,0,0,112
06/30/1989,1,104,2,0,5,112
07/31/1989,0,106,0,0,1,107
08/31/1989,2,99,4,1,0,106
09/30/1989,0,107,0,0,0,107
10/31/1989,0,108,1,0,1,110
11/30/1989,2,107,0,0,1,110
12/31/1989,0,105,1,0,3,109
01/31/1990,0,103,1,0,2,106
02/28/1990,0,101,0,2,1,104
03/31/1990,0,99,0,0,2,101
04/30/1990,0,95,2,0,2,99
05/31/1990,0,88,7,1,1,97
06/30/1990,0,94,1,0,0,95
07/31/1990,0,95,0,0,0,95
08/31/1990,0,95,0,0,0,95
09/30/1990,0,95,0,0,0,95
10/31/1990,2,92,1,0,0,95
11/30/1990,0,94,0,0,1,95
12/31/1990,0,93,0,1,0,94
01/31/1991,0,89,2,1,1,93
02/28/1991,0,90,0,1,1,92
03/31/1991,0,80,10,0,0,90
04/30/1991,0,90,1,1,0,92
05/31/1991,0,93,0,0,0,93
06/30/1991,0,91,0,2,0,93
07/31/1991,1,90,0,0,0,91
08/31/1991,0,91,0,0,0,91
09/30/1991,0,91,1,0,0,92
10/31/1991,0,90,2,0,0,92
11/30/1991,0,92,0,0,0,92
12/31/1991,0,91,1,0,1,93
01/31/1992,0,93,0,0,0,93
02/29/1992,0,92,1,0,0,93
03/31/1992,2,92,0,0,0,94
04/30/1992,0,93,0,0,1,94
05/31/1992,0,92,1,0,0,93
06/30/1992,0,92,0,0,1,93
07/31/1992,0,91,2,0,0,93
08/31/1992,0,96,0,0,0,96
09/30/1992,1,96,0,0,0,97
10/31/1992,0,95,3,0,0,98
11/30/1992,0,96,3,0,0,99
12/31/1992,0,99,0,0,0,99
01/31/1993,0,100,0,0,0,100
02/28/1993,1,97,1,0,1,100
03/31/1993,0,93,6,0,0,99
04/30/1993,2,97,0,0,1,100
05/31/1993,1,101,0,0,0,102
06/30/1993,0,101,0,0,2,103
07/31/1993,6,97,1,0,0,104
08/31/1993,0,102,1,0,1,104
09/30/1993,0,104,0,0,1,105
10/31/1993,2,102,1,0,3,108
11/30/1993,0,107,0,0,0,107
12/31/1993,1,109,0,0,0,110
01/31/1994,0,113,0,0,2,115
02/28/1994,0,112,0,1,0,113
03/31/1994,0,112,1,0,0,113
04/30/1994,0,113,0,0,0,113
05/31/1994,1,114,0,0,0,115
06/30/1994,0,116,0,0,0,116
07/31/1994,0,115,0,0,1,116
08/31/1994,0,118,0,0,0,118
09/30/1994,0,116,1,0,1,118
10/31/1994,0,115,0,1,1,117
11/30/1994,1,114,0,0,1,116
12/31/1994,0,117,0,0,0,117
01/31/1995,0,117,0,0,0,117
02/28/1995,1,116,0,1,0,118
03/31/1995,1,115,1,0,0,117
04/30/1995,0,115,0,0,2,117
05/31/1995,0,116,1,0,0,117
06/30/1995,0,117,0,0,0,117
07/31/1995,0,115,0,0,3,118
08/31/1995,0,112,4,0,1,117
09/30/1995,0,115,0,0,1,116
10/31/1995,1,111,1,0,2,115
11/30/1995,0,110,2,1,0,113
12/31/1995,0,113,0,1,0,114
01/31/1996,0,115,0,0,0,115
02/29/1996,0,116,0,0,0,116
03/31/1996,0,116,1,0,0,117
04/30/1996,2,115,0,0,2,119
05/31/1996,1,116,0,0,1,118
06/30/1996,1,117,1,0,0,119
07/31/1996,3,112,4,0,1,120
08/31/1996,0,120,0,0,1,121
09/30/1996,0,121,0,0,0,121
10/31/1996,0,119,1,0,1,121
11/30/1996,0,120,0,0,0,120
12/31/1996,0,122,0,0,0,122
01/31/1997,0,123,0,0,0,123
02/28/1997,0,122,1,0,1,124
03/31/1997,0,120,0,0,3,123
04/30/1997,1,120,0,0,0,121
05/31/1997,1,113,6,0,1,121
06/30/1997,1,119,1,0,1,122
07/31/1997,1,122,0,0,2,125
08/31/1997,1,126,0,0,0,127
09/30/1997,1,124,0,0,4,129
10/31/1997,2,128,2,0,0,132
11/30/1997,1,134,0,0,1,136
12/31/1997,0,135,0,0,0,135
01/31/1998,0,137,0,0,0,137
02/28/1998,0,136,0,0,3,139
03/31/1998,0,141,0,0,0,141
04/30/1998,0,139,1,0,2,142
05/31/1998,0,143,1,0,0,144
06/30/1998,0,144,1,0,2,147
07/31/1998,0,146,0,0,3,149
08/31/1998,0,147,1,0,1,149
09/30/1998,0,145,4,0,0,149
10/31/1998,0,148,1,0,1,150
11/30/1998,0,145,2,1,1,149
12/31/1998,0,144,0,0,3,147
01/31/1999,0,143,1,1,0,145
02/28/1999,0,144,0,1,0,145
03/31/1999,1,142,3,1,0,147
04/30/1999,0,144,1,0,2,147
05/31/1999,0,142,2,1,0,145
06/30/1999,1,140,3,1,0,145
07/31/1999,0,144,0,1,0,145
08/31/1999,1,143,1,0,0,145
09/30/1999,0,142,2,1,0,145
10/31/1999,0,142,1,0,1,144
11/30/1999,0,144,0,1,0,145
12/31/1999,1,142,1,0,0,144
01/31/2000,0,141,2,1,0,144
02/29/2000,0,141,3,2,0,146
03/31/2000,1,142,0,0,1,144
04/30/2000,0,140,2,0,1,143
05/31/2000,1,135,3,2,1,142
06/30/2000,2,133,3,1,1,140
07/31/2000,0,137,2,0,0,139
08/31/2000,0,138,1,0,1,140
09/30/2000,0,137,0,1,1,139
10/31/2000,0,138,0,0,1,139
11/30/2000,0,138,1,1,0,140
12/31/2000,1,137,2,0,0,140
01/31/2001,0,135,1,2,2,140
02/28/2001,3,136,0,0,0,139
03/31/2001,0,138,1,0,0,139
04/30/2001,0,138,2,0,0,140
05/31/2001,1,139,0,1,0,141
06/30/2001,0,141,0,0,0,141
07/31/2001,0,140,0,0,1,141
08/31/2001,1,138,0,1,1,141
09/30/2001,0,134,6,0,0,140
10/31/2001,0,138,3,0,0,141
11/30/2001,2,141,0,1,0,144
12/31/2001,0,140,2,1,1,144
01/31/2002,0,140,1,2,0,143
02/28/2002,1,140,2,0,1,144
03/31/2002,0,142,1,0,1,144
04/30/2002,1,139,1,1,2,144
05/31/2002,0,139,1,1,0,141
06/30/2002,1,139,2,1,0,143
07/31/2002,1,140,1,0,2,144
08/31/2002,0,138,1,1,2,142
09/30/2002,0,139,1,0,0,140
10/31/2002,0,137,0,1,2,140
11/30/2002,0,136,2,0,0,138
12/31/2002,0,134,2,2,0,138
01/31/2003,0,132,3,1,0,136
02/28/2003,0,136,2,0,0,138
03/31/2003,1,131,4,1,1,138
04/30/2003,0,140,1,1,0,142
05/31/2003,0,141,1,1,0,143
06/30/2003,1,142,0,0,0,143
07/31/2003,0,144,3,0,0,147
08/31/2003,0,148,1,0,0,149
09/30/2003,1,146,0,0,2,149
10/31/2003,0,147,2,0,0,149
11/30/2003,1,166,0,0,1,168
12/31/2003,0,167,0,0,2,169
01/31/2004,0,167,1,0,1,169
02/29/2004,0,169,0,0,0,169
03/31/2004,0,165,0,0,5,170
04/30/2004,0,166,0,0,1,167
05/31/2004,0,166,1,0,0,167
06/30/2004,0,165,2,0,0,167
07/31/2004,0,170,1,0,0,171
08/31/2004,0,170,2,0,0,172
09/30/2004,0,170,1,1,1,173
10/31/2004,1,169,1,1,0,172
11/30/2004,0,172,0,0,0,172
12/31/2004,1,172,2,0,1,176
01/31/2005,0,176,2,0,0,178
02/28/2005,0,179,0,1,1,181
03/31/2005,1,177,0,0,1,179
04/30/2005,2,176,1,0,0,179
05/31/2005,0,178,2,0,0,180
06/30/2005,2,177,1,0,0,180
07/31/2005,1,178,0,1,0,180
08/31/2005,0,175,2,0,3,180
09/30/2005,1,173,0,2,1,177
10/31/2005,2,173,1,0,0,176
11/30/2005,2,173,1,1,1,178
12/31/2005,2,173,2,0,1,178
01/31/2006,2,174,1,0,0,177
02/28/2006,1,176,1,0,0,178
03/31/2006,0,176,2,0,1,179
04/30/2006,0,175,3,0,1,179
05/31/2006,0,179,1,0,0,180
06/30/2006,0,179,1,0,0,180
07/31/2006,0,180,1,0,0,181
08/31/2006,0,181,2,0,0,183
09/30/2006,0,185,0,0,0,185
10/31/2006,1,181,1,1,2,186
11/30/2006,0,183,0,0,1,184
12/31/2006,0,184,1,0,1,186
01/31/2007,1,179,0,0,6,186
02/28/2007,0,178,0,0,3,181
03/31/2007,2,176,1,0,0,179
04/30/2007,0,181,0,0,0,181
05/31/2007,0,183,1,0,1,185
06/30/2007,7,180,0,0,1,188
07/31/2007,0,188,0,0,2,190
08/31/2007,0,188,1,0,1,190
09/30/2007,0,187,2,0,0,189
10/31/2007,0,189,1,0,2,192
11/30/2007,0,186,3,0,1,190
12/31/2007,1,188,2,0,0,191
01/31/2008,0,191,2,0,0,193
02/29/2008,0,192,1,0,1,194
03/31/2008,0,190,1,0,2,193
04/30/2008,0,188,2,0,1,191
05/31/2008,0,188,3,0,0,191
06/30/2008,1,187,1,0,2,191
07/31/2008,0,187,1,2,0,190
08/31/2008,0,183,4,0,3,190
09/30/2008,0,186,0,0,1,187
10/31/2008,0,177,4,0,5,186
11/30/2008,0,172,5,1,4,182
12/31/2008,0,170,6,0,1,177
01/31/2009,1,173,1,1,0,176
02/28/2009,0,171,3,0,1,175
03/31/2009,0,171,2,0,2,175
04/30/2009,0,157,1,0,15,173
05/31/2009,0,156,1,0,1,158
06/30/2009,0,151,6,1,1,159
07/31/2009,1,155,2,2,0,160
08/31/2009,0,160,0,0,0,160
09/30/2009,0,159,1,0,0,160
10/31/2009,2,156,1,1,0,160
11/30/2009,1,155,3,0,1,160
12/31/2009,1,155,3,1,1,161
01/31/2010,1,155,0,1,3,160
02/28/2010,0,157,1,0,0,158
03/31/2010,1,159,1,0,0,161
04/30/2010,0,159,4,0,0,163
05/31/2010,0,164,1,0,0,165
06/30/2010,2,164,0,0,1,167
07/31/2010,1,165,0,1,1,168
08/31/2010,2,167,0,0,0,169
09/30/2010,0,168,0,0,1,169
10/31/2010,0,171,0,0,0,171
11/30/2010,1,173,0,0,0,174
12/31/2010,5,169,1,0,1,176
01/31/2011,0,173,1,0,1,175
02/28/2011,0,177,0,0,0,177
03/31/2011,0,175,3,0,0,178
04/30/2011,1,179,1,0,0,181
05/31/2011,1,180,1,0,0,182
06/30/2011,1,182,1,0,0,184
07/31/2011,2,184,0,1,1,188
08/31/2011,1,182,0,2,2,187
09/30/2011,0,180,3,0,2,185
10/31/2011,0,182,0,3,0,185
11/30/2011,0,180,1,1,1,183
12/31/2011,0,179,2,0,0,181
01/31/2012,0,176,3,1,1,181
02/29/2012,0,176,2,2,0,180
03/31/2012,1,175,1,0,2,179
04/30/2012,4,171,3,0,0,178
05/31/2012,0,179,0,0,1,180
06/30/2012,1,175,2,1,2,181
07/31/2012,0,178,4,0,0,182
08/31/2012,0,182,0,1,2,185
09/30/2012,0,179,3,0,1,183
10/31/2012,0,182,1,0,1,184
11/30/2012,0,179,2,1,2,184
12/31/2012,0,180,2,0,0,182
01/31/2013,0,180,0,1,1,182
02/28/2013,1,177,1,0,2,181
03/31/2013,3,174,1,0,1,179
04/30/2013,2,177,1,2,0,182
05/31/2013,1,185,0,0,0,186
06/30/2013,0,187,0,0,4,191
07/31/2013,1,190,0,0,0,191
08/31/2013,1,193,1,0,1,196
09/30/2013,0,197,0,0,0,197
10/31/2013,0,196,0,1,1,198
11/30/2013,0,197,0,0,1,198
12/31/2013,2,192,3,0,3,200
01/31/2014,0,198,1,0,3,202
02/28/2014,0,197,3,0,0,200
03/31/2014,1,201,1,1,0,204
04/30/2014,0,204,1,0,2,207
05/31/2014,2,202,2,0,1,207
06/30/2014,1,202,2,0,1,206
07/31/2014,0,208,0,0,0,208
08/31/2014,0,208,0,0,3,211
09/30/2014,0,207,0,0,3,210
10/31/2014,0,209,0,0,0,209
11/30/2014,1,210,0,0,1,212
12/31/2014,0,211,0,0,1,212
01/31/2015,0,213,0,0,0,213
02/28/2015,1,213,2,0,0,216
03/31/2015,1,216,0,0,1,218
04/30/2015,0,215,2,1,4,222
05/31/2015,2,215,1,2,0,220
06/30/2015,4,215,1,0,1,221
07/31/2015,0,222,1,0,1,224
08/31/2015,1,222,1,0,2,226
09/30/2015,0,218,2,0,4,224
10/31/2015,1,218,0,0,2,221
11/30/2015,4,214,0,0,1,219
12/31/2015,0,218,2,0,2,222
01/31/2016,0,218,0,1,2,221
02/29/2016,3,214,3,0,0,220
03/31/2016,1,217,2,0,0,220
04/30/2016,0,219,1,0,1,221
05/31/2016,0,216,4,0,2,222
06/30/2016,1,218,1,1,1,222
07/31/2016,1,217,1,2,1,222
08/31/2016,0,217,2,0,2,221
09/30/2016,1,216,2,1,0,220
10/31/2016,0,220,0,0,0,220
11/30/2016,3,213,3,1,0,220
12/31/2016,0,218,2,1,0,221
01/31/2017,0,219,1,0,1,221
02/28/2017,0,224,0,0,0,224
03/31/2017,0,224,0,1,0,225
04/30/2017,0,223,1,0,0,224
05/31/2017,1,224,1,0,2,228
06/30/2017,0,224,2,0,1,227
07/31/2017,0,226,0,0,3,229
08/31/2017,1,225,1,0,1,228
09/30/2017,1,222,4,0,0,227
10/31/2017,2,227,0,0,1,230
11/30/2017,0,231,1,0,0,232
12/31/2017,1,234,0,0,1,236
01/31/2018,0,234,1,0,1,236
02/28/2018,3,228,1,1,2,235
03/31/2018,1,228,2,0,2,233
04/30/2018,1,228,2,0,1,232
05/31/2018,3,228,0,1,1,233
06/30/2018,0,230,0,0,4,234
07/31/2018,0,230,0,0,1,231
08/31/2018,0,231,1,0,0,232
09/30/2018,2,229,1,0,1,233
10/31/2018,0,231,1,0,2,234
11/30/2018,2,228,2,0,1,233
12/31/2018,0,231,1,0,2,234
01/31/2019,0,231,0,1,1,233
02/28/2019,0,230,1,0,0,231
03/31/2019,0,230,0,0,1,231
04/30/2019,1,225,1,0,4,231
05/31/2019,1,227,1,0,0,229
06/30/2019,0,229,0,0,1,230
07/31/2019,0,227,1,1,0,229
08/31/2019,3,227,0,0,0,230
09/30/2019,0,230,0,0,2,232
10/31/2019,1,229,0,0,1,231
11/30/2019,0,231,0,0,0,231
12/31/2019,0,228,5,0,0,233
01/31/2020,0,232,3,0,1,236
02/29/2020,0,232,0,2,3,237
03/31/2020,0,220,13,0,0,233
04/30/2020,0,221,10,1,2,234
05/31/2020,0,220,6,4,1,231
06/30/2020,0,222,6,0,0,228
07/31/2020,2,213,10,1,2,228
08/31/2020,0,225,2,0,0,227
09/30/2020,0,226,2,1,0,229
10/31/2020,1,224,1,2,0,228
11/30/2020,0,223,2,1,1,227
12/31/2020,0,222,1,0,2,225
01/31/2021,0,223,0,0,1,224
02/28/2021,1,219,2,0,2,224
03/31/2021,5,213,2,2,1,223
04/30/2021,2,215,4,0,1,222
05/31/2021,1,222,1,2,0,226
06/30/2021,2,223,0,0,1,226
07/31/2021,1,225,1,0,1,228
08/31/2021,2,226,0,0,2,230
09/30/2021,0,227,0,0,1,228
