Up/Down,Upgrade,Same,Downgrade,Defaulted,Non-Rated,Totals
01/31/1981,0,230,5,0,0,235
02/28/1981,0,235,0,0,0,235
03/31/1981,0,231,4,0,0,235
04/30/1981,0,233,2,0,0,235
05/31/1981,0,234,1,0,0,235
06/30/1981,0,235,0,0,0,235
07/31/1981,0,235,1,0,0,236
08/31/1981,0,236,0,0,0,236
09/30/1981,2,233,1,0,0,236
10/31/1981,2,234,1,0,0,237
11/30/1981,1,237,1,0,0,239
12/31/1981,1,236,1,0,1,239
01/31/1982,0,236,2,0,0,238
02/28/1982,0,238,0,0,0,238
03/31/1982,0,236,2,0,0,238
04/30/1982,0,237,1,0,0,238
05/31/1982,0,237,1,0,0,238
06/30/1982,1,237,1,0,0,239
07/31/1982,0,236,1,1,1,239
08/31/1982,1,234,2,0,0,237
09/30/1982,2,233,1,0,1,237
10/31/1982,0,235,1,0,0,236
11/30/1982,0,236,0,0,0,236
12/31/1982,1,232,3,0,0,236
01/31/1983,0,235,2,0,0,237
02/28/1983,0,235,3,0,0,238
03/31/1983,0,238,0,0,0,238
04/30/1983,0,235,5,0,1,241
05/31/1983,0,237,3,0,0,240
06/30/1983,1,238,0,0,1,240
07/31/1983,2,236,0,0,1,239
08/31/1983,0,237,2,0,0,239
09/30/1983,4,235,0,0,1,240
10/31/1983,2,237,1,0,0,240
11/30/1983,0,237,3,0,0,240
12/31/1983,1,236,3,0,0,240
01/31/1984,0,240,0,0,0,240
02/29/1984,2,234,4,0,0,240
03/31/1984,2,239,0,0,0,241
04/30/1984,1,237,2,0,1,241
05/31/1984,4,235,1,0,0,240
06/30/1984,1,240,0,0,0,241
07/31/1984,1,238,2,0,0,241
08/31/1984,1,240,1,0,0,242
09/30/1984,2,242,1,0,0,245
10/31/1984,3,240,3,0,0,246
11/30/1984,2,244,1,0,0,247
12/31/1984,3,247,1,0,0,251
01/31/1985,3,246,0,0,2,251
02/28/1985,5,244,2,0,0,251
03/31/1985,1,247,4,0,0,252
04/30/1985,4,243,6,0,0,253
05/31/1985,1,246,6,0,0,253
06/30/1985,1,250,2,0,1,254
07/31/1985,1,252,0,0,0,253
08/31/1985,0,253,0,0,0,253
09/30/1985,0,254,0,0,0,254
10/31/1985,1,252,0,0,1,254
11/30/1985,1,254,0,0,0,255
12/31/1985,1,254,0,0,0,255
01/31/1986,0,250,1,0,5,256
02/28/1986,1,250,2,0,0,253
03/31/1986,0,254,1,0,0,255
04/30/1986,10,245,1,0,0,256
05/31/1986,2,250,3,0,1,256
06/30/1986,1,255,1,0,0,257
07/31/1986,1,257,2,0,0,260
08/31/1986,1,259,1,0,0,261
09/30/1986,0,260,0,0,2,262
10/31/1986,1,256,2,0,1,260
11/30/1986,0,255,4,0,0,259
12/31/1986,0,254,7,0,0,261
01/31/1987,1,260,0,0,0,261
02/28/1987,1,263,1,0,0,265
03/31/1987,3,258,3,0,1,265
04/30/1987,3,260,0,0,1,264
05/31/1987,1,258,4,0,0,263
06/30/1987,2,254,4,1,2,263
07/31/1987,2,257,3,0,1,263
08/31/1987,0,260,2,0,1,263
09/30/1987,1,261,1,0,0,263
10/31/1987,0,261,2,0,0,263
11/30/1987,0,266,0,0,0,266
12/31/1987,0,264,2,0,0,266
01/31/1988,1,262,1,1,4,269
02/29/1988,1,263,1,0,2,267
03/31/1988,0,264,1,0,0,265
04/30/1988,0,266,0,0,0,266
05/31/1988,1,260,3,0,2,266
06/30/1988,0,264,1,0,0,265
07/31/1988,2,263,0,0,1,266
08/31/1988,4,255,4,1,1,265
09/30/1988,0,263,0,0,0,263
10/31/1988,2,261,0,0,0,263
11/30/1988,0,263,0,0,0,263
12/31/1988,0,261,2,0,0,263
01/31/1989,1,260,1,0,1,263
02/28/1989,0,262,1,0,0,263
03/31/1989,3,255,5,0,0,263
04/30/1989,0,263,1,0,1,265
05/31/1989,0,261,3,0,0,264
06/30/1989,5,258,0,0,1,264
07/31/1989,0,260,2,0,1,263
08/31/1989,1,260,0,0,1,262
09/30/1989,4,258,0,0,0,262
10/31/1989,0,259,3,0,1,263
11/30/1989,0,261,1,0,0,262
12/31/1989,0,261,2,0,0,263
01/31/1990,0,262,1,0,0,263
02/28/1990,1,262,1,0,0,264
03/31/1990,0,264,0,0,0,264
04/30/1990,3,260,1,0,1,265
05/31/1990,1,260,0,0,3,264
06/30/1990,2,261,0,0,0,263
07/31/1990,1,261,0,0,1,263
08/31/1990,4,258,1,0,0,263
09/30/1990,3,260,0,0,0,263
10/31/1990,5,254,3,0,2,264
11/30/1990,2,258,4,0,0,264
12/31/1990,1,261,1,0,2,265
01/31/1991,0,265,0,0,0,265
02/28/1991,0,266,0,0,0,266
03/31/1991,1,263,2,0,0,266
04/30/1991,1,264,0,0,1,266
05/31/1991,0,264,1,0,0,265
06/30/1991,1,264,1,0,1,267
07/31/1991,1,263,0,1,1,266
08/31/1991,0,263,0,1,0,264
09/30/1991,0,262,1,0,0,263
10/31/1991,0,267,0,0,0,267
11/30/1991,2,266,1,0,0,269
12/31/1991,1,268,3,1,0,273
01/31/1992,1,269,2,2,0,274
02/29/1992,0,270,5,0,0,275
03/31/1992,1,275,1,0,0,277
04/30/1992,3,270,6,1,0,280
05/31/1992,0,279,0,0,0,279
06/30/1992,0,281,0,0,0,281
07/31/1992,1,281,0,0,1,283
08/31/1992,0,280,2,0,0,282
09/30/1992,0,281,0,0,1,282
10/31/1992,1,282,0,0,1,284
11/30/1992,2,286,1,0,0,289
12/31/1992,0,291,0,0,1,292
01/31/1993,0,291,0,0,0,291
02/28/1993,0,288,5,0,0,293
03/31/1993,0,293,1,0,0,294
04/30/1993,0,296,0,0,0,296
05/31/1993,1,296,0,0,0,297
06/30/1993,1,294,2,0,0,297
07/31/1993,0,299,0,0,0,299
08/31/1993,1,299,0,0,0,300
09/30/1993,0,296,3,0,3,302
10/31/1993,0,295,1,0,3,299
11/30/1993,0,296,0,0,0,296
12/31/1993,0,293,5,0,3,301
01/31/1994,0,296,1,0,1,298
02/28/1994,2,298,1,0,1,302
03/31/1994,1,299,2,0,1,303
04/30/1994,0,299,1,0,2,302
05/31/1994,1,303,0,0,0,304
06/30/1994,0,301,2,0,2,305
07/31/1994,0,304,0,0,0,304
08/31/1994,0,303,1,0,1,305
09/30/1994,0,304,1,0,0,305
10/31/1994,1,303,2,0,1,307
11/30/1994,0,306,0,0,1,307
12/31/1994,0,308,1,0,0,309
01/31/1995,0,309,1,0,0,310
02/28/1995,2,310,0,0,0,312
03/31/1995,0,312,1,0,0,313
04/30/1995,1,311,0,0,1,313
05/31/1995,1,312,1,0,0,314
06/30/1995,0,315,1,0,0,316
07/31/1995,5,306,1,0,4,316
08/31/1995,1,312,1,0,0,314
09/30/1995,0,316,0,0,0,316
10/31/1995,0,316,1,0,2,319
11/30/1995,0,321,0,0,0,321
12/31/1995,3,318,0,0,1,322
01/31/1996,1,321,1,0,0,323
02/29/1996,0,322,3,0,0,325
03/31/1996,0,324,1,0,2,327
04/30/1996,0,328,0,0,0,328
05/31/1996,1,327,2,0,2,332
06/30/1996,1,333,0,0,0,334
07/31/1996,0,334,2,0,0,336
08/31/1996,1,336,0,0,0,337
09/30/1996,4,334,1,0,0,339
10/31/1996,0,340,1,0,0,341
11/30/1996,1,341,0,0,0,342
12/31/1996,0,346,0,0,0,346
01/31/1997,1,347,1,0,0,349
02/28/1997,0,350,1,0,1,352
03/31/1997,0,351,1,0,1,353
04/30/1997,1,352,2,0,1,356
05/31/1997,0,351,4,0,1,356
06/30/1997,3,356,3,0,0,362
07/31/1997,2,360,2,0,0,364
08/31/1997,0,364,0,0,4,368
09/30/1997,0,367,0,0,0,367
10/31/1997,2,366,4,0,0,372
11/30/1997,0,385,0,0,0,385
12/31/1997,0,387,0,0,0,387
01/31/1998,3,386,2,0,2,393
02/28/1998,1,395,1,0,0,397
03/31/1998,0,400,1,0,0,401
04/30/1998,1,407,0,0,0,408
05/31/1998,1,409,1,0,2,413
06/30/1998,0,414,0,0,1,415
07/31/1998,0,417,2,0,0,419
08/31/1998,2,422,1,0,0,425
09/30/1998,0,426,2,0,0,428
10/31/1998,0,429,3,0,1,433
11/30/1998,0,433,2,0,2,437
12/31/1998,1,437,4,0,1,443
01/31/1999,3,440,0,1,1,445
02/28/1999,3,445,1,0,1,450
03/31/1999,3,447,1,0,2,453
04/30/1999,4,447,2,0,1,454
05/31/1999,4,451,0,0,1,456
06/30/1999,0,454,1,0,5,460
07/31/1999,0,452,0,0,6,458
08/31/1999,3,449,4,0,0,456
09/30/1999,3,457,3,0,1,464
10/31/1999,0,462,3,0,1,466
11/30/1999,0,469,0,0,2,471
12/31/1999,6,461,4,0,0,471
01/31/2000,0,464,10,0,0,474
02/29/2000,1,471,3,0,1,476
03/31/2000,2,471,6,0,1,480
04/30/2000,0,479,6,0,1,486
05/31/2000,1,482,3,1,1,488
06/30/2000,5,481,1,0,0,487
07/31/2000,0,492,0,1,0,493
08/31/2000,1,486,3,0,3,493
09/30/2000,2,488,2,0,1,493
10/31/2000,2,480,11,0,3,496
11/30/2000,0,497,3,0,0,500
12/31/2000,1,497,6,0,1,505
01/31/2001,0,496,6,2,4,508
02/28/2001,0,508,0,0,0,508
03/31/2001,0,500,11,0,1,512
04/30/2001,0,514,0,0,4,518
05/31/2001,2,512,3,0,2,519
06/30/2001,1,518,2,0,3,524
07/31/2001,0,525,3,0,2,530
08/31/2001,3,521,4,0,1,529
09/30/2001,8,514,6,0,1,529
10/31/2001,1,510,16,0,2,529
11/30/2001,0,537,10,0,2,549
12/31/2001,5,528,13,1,0,547
01/31/2002,0,540,3,4,2,549
02/28/2002,2,532,7,1,4,546
03/31/2002,0,523,11,9,3,546
04/30/2002,0,528,10,0,0,538
05/31/2002,2,521,17,1,0,541
06/30/2002,1,525,12,0,3,541
07/31/2002,1,518,19,0,3,541
08/31/2002,2,527,6,1,7,543
09/30/2002,7,511,14,3,2,537
10/31/2002,7,504,20,1,2,534
11/30/2002,0,515,15,1,3,534
12/31/2002,0,516,15,0,2,533
01/31/2003,2,521,5,0,4,532
02/28/2003,1,518,9,2,2,532
03/31/2003,0,524,5,1,2,532
04/30/2003,2,521,4,2,1,530
05/31/2003,1,513,12,0,2,528
06/30/2003,1,517,10,0,2,530
07/31/2003,1,519,5,3,3,531
08/31/2003,0,523,6,0,3,532
09/30/2003,0,528,0,1,1,530
10/31/2003,1,521,7,0,1,530
11/30/2003,1,528,5,0,2,536
12/31/2003,3,522,7,0,2,534
01/31/2004,1,531,0,1,1,534
02/29/2004,0,529,2,0,1,532
03/31/2004,5,525,1,0,3,534
04/30/2004,0,532,0,0,4,536
05/31/2004,0,535,0,0,2,537
06/30/2004,0,535,1,0,0,536
07/31/2004,2,535,1,0,1,539
08/31/2004,2,532,1,0,3,538
09/30/2004,0,534,1,0,3,538
10/31/2004,2,536,0,0,1,539
11/30/2004,1,538,3,0,0,542
12/31/2004,1,541,3,0,1,546
01/31/2005,1,542,2,0,3,548
02/28/2005,1,545,2,0,1,549
03/31/2005,1,546,1,0,0,548
04/30/2005,0,549,1,0,0,550
05/31/2005,5,540,6,0,0,551
06/30/2005,0,542,6,0,5,553
07/31/2005,0,545,1,0,2,548
08/31/2005,2,539,1,0,6,548
09/30/2005,0,540,0,1,1,542
10/31/2005,0,528,13,0,5,546
11/30/2005,1,539,3,0,0,543
12/31/2005,0,540,1,1,6,548
01/31/2006,1,542,0,0,2,545
02/28/2006,2,537,2,0,3,544
03/31/2006,2,538,0,0,1,541
04/30/2006,1,536,0,0,3,540
05/31/2006,5,531,1,0,3,540
06/30/2006,0,536,2,0,2,540
07/31/2006,0,537,0,0,6,543
08/31/2006,0,538,0,0,0,538
09/30/2006,6,530,2,0,0,538
10/31/2006,3,532,0,0,3,538
11/30/2006,3,542,0,0,1,546
12/31/2006,0,544,0,0,2,546
01/31/2007,3,538,2,0,3,546
02/28/2007,5,537,0,0,1,543
03/31/2007,3,537,2,0,3,545
04/30/2007,0,538,4,0,3,545
05/31/2007,14,527,0,0,4,545
06/30/2007,2,534,2,0,5,543
07/31/2007,3,540,0,0,3,546
08/31/2007,1,539,0,0,4,544
09/30/2007,0,538,0,0,3,541
10/31/2007,1,534,2,0,1,538
11/30/2007,5,533,0,0,1,539
12/31/2007,4,533,0,0,2,539
01/31/2008,0,538,0,0,1,539
02/29/2008,2,533,1,0,3,539
03/31/2008,3,530,3,0,1,537
04/30/2008,1,530,2,0,3,536
05/31/2008,0,535,0,0,0,535
06/30/2008,2,531,2,0,1,536
07/31/2008,1,531,1,0,3,536
08/31/2008,3,546,0,0,1,550
09/30/2008,5,545,1,0,0,551
10/31/2008,0,548,3,0,1,552
11/30/2008,1,542,4,0,6,553
12/31/2008,0,545,1,0,1,547
01/31/2009,2,539,4,0,1,546
02/28/2009,0,541,6,0,0,547
03/31/2009,0,539,7,0,2,548
04/30/2009,5,525,5,0,13,548
05/31/2009,1,530,4,0,0,535
06/30/2009,1,527,7,0,1,536
07/31/2009,0,525,5,0,9,539
08/31/2009,2,527,1,0,0,530
09/30/2009,0,524,2,0,4,530
10/31/2009,2,523,2,0,0,527
11/30/2009,1,525,1,1,1,529
12/31/2009,1,529,2,0,1,533
01/31/2010,0,530,5,0,0,535
02/28/2010,0,533,2,0,2,537
03/31/2010,0,534,2,0,2,538
04/30/2010,1,539,0,0,1,541
05/31/2010,0,540,2,0,1,543
06/30/2010,6,534,1,1,1,543
07/31/2010,2,536,2,0,1,541
08/31/2010,3,537,0,1,1,542
09/30/2010,0,544,0,0,2,546
10/31/2010,0,543,0,0,1,544
11/30/2010,0,536,7,0,0,543
12/31/2010,1,542,3,0,4,550
01/31/2011,0,546,0,0,2,548
02/28/2011,0,548,0,0,1,549
03/31/2011,2,538,7,0,2,549
04/30/2011,1,544,2,1,0,548
05/31/2011,0,549,3,0,0,552
06/30/2011,2,547,1,0,3,553
07/31/2011,1,547,2,0,4,554
08/31/2011,1,549,0,0,0,550
09/30/2011,2,548,1,0,0,551
10/31/2011,1,548,2,0,0,551
11/30/2011,1,548,2,0,0,551
12/31/2011,1,543,7,0,1,552
01/31/2012,4,545,2,0,3,554
02/29/2012,0,546,8,0,0,554
03/31/2012,0,542,7,1,4,554
04/30/2012,7,540,2,0,0,549
05/31/2012,3,530,15,1,1,550
06/30/2012,0,550,2,0,0,552
07/31/2012,0,541,8,0,5,554
08/31/2012,0,547,1,0,1,549
09/30/2012,1,550,1,0,0,552
10/31/2012,0,549,3,0,0,552
11/30/2012,0,551,4,1,0,556
12/31/2012,1,552,1,3,1,558
01/31/2013,2,551,0,1,1,555
02/28/2013,3,550,1,0,1,555
03/31/2013,1,554,0,0,3,558
04/30/2013,0,557,0,0,1,558
05/31/2013,7,547,6,0,0,560
06/30/2013,0,561,0,0,2,563
07/31/2013,1,557,3,0,1,562
08/31/2013,4,558,0,0,0,562
09/30/2013,0,563,1,0,1,565
10/31/2013,1,566,0,0,1,568
11/30/2013,0,567,1,0,2,570
12/31/2013,11,551,7,0,2,571
01/31/2014,0,572,0,0,0,572
02/28/2014,0,571,2,0,0,573
03/31/2014,0,571,1,0,1,573
04/30/2014,1,572,2,1,0,576
05/31/2014,3,573,1,1,0,578
06/30/2014,0,575,2,0,0,577
07/31/2014,0,578,0,0,2,580
08/31/2014,0,582,0,0,0,582
09/30/2014,4,578,3,0,1,586
10/31/2014,0,582,4,0,4,590
11/30/2014,1,588,0,0,0,589
12/31/2014,1,591,1,0,0,593
01/31/2015,0,596,1,0,0,597
02/28/2015,0,596,4,0,1,601
03/31/2015,0,596,2,0,2,600
04/30/2015,12,585,2,0,1,600
05/31/2015,2,597,2,0,1,602
06/30/2015,7,591,2,0,4,604
07/31/2015,0,602,2,0,0,604
08/31/2015,1,598,2,0,5,606
09/30/2015,1,593,6,0,4,604
10/31/2015,10,592,2,0,0,604
11/30/2015,1,599,3,0,4,607
12/31/2015,2,602,1,0,0,605
01/31/2016,1,603,0,0,3,607
02/29/2016,9,586,8,0,3,606
03/31/2016,1,603,1,0,1,606
04/30/2016,5,597,1,0,2,605
05/31/2016,1,597,4,0,2,604
06/30/2016,7,596,1,0,0,604
07/31/2016,2,597,0,0,6,605
08/31/2016,1,593,4,1,2,601
09/30/2016,6,588,3,0,4,601
10/31/2016,2,596,2,1,1,602
11/30/2016,0,599,5,0,1,605
12/31/2016,0,601,1,1,3,606
01/31/2017,0,600,1,0,5,606
02/28/2017,6,595,0,0,4,605
03/31/2017,0,600,0,0,1,601
04/30/2017,3,591,3,0,4,601
05/31/2017,4,591,3,0,2,600
06/30/2017,1,601,0,0,1,603
07/31/2017,1,600,2,0,3,606
08/31/2017,2,602,0,0,0,604
09/30/2017,3,597,4,0,0,604
10/31/2017,1,604,0,0,1,606
11/30/2017,1,604,0,1,0,606
12/31/2017,2,604,1,0,0,607
01/31/2018,0,604,0,0,5,609
02/28/2018,5,597,3,0,1,606
03/31/2018,5,595,1,0,4,605
04/30/2018,0,598,0,2,1,601
05/31/2018,0,599,3,0,0,602
06/30/2018,6,592,2,0,3,603
07/31/2018,0,595,3,0,3,601
08/31/2018,3,597,1,0,1,602
09/30/2018,7,594,0,0,1,602
10/31/2018,1,600,0,0,1,602
11/30/2018,0,595,2,0,4,601
12/31/2018,0,585,10,0,2,597
01/31/2019,0,586,1,2,8,597
02/28/2019,1,579,9,0,2,591
03/31/2019,4,584,1,0,1,590
04/30/2019,0,588,0,0,2,590
05/31/2019,0,584,0,0,4,588
06/30/2019,1,584,1,0,1,587
07/31/2019,0,585,0,0,1,586
08/31/2019,5,578,0,0,3,586
09/30/2019,0,578,1,0,4,583
10/31/2019,4,576,0,0,1,581
11/30/2019,2,579,2,0,0,583
12/31/2019,3,576,2,0,3,584
01/31/2020,0,575,2,1,3,581
02/29/2020,1,570,3,0,3,577
03/31/2020,1,573,3,0,0,577
04/30/2020,0,573,5,0,0,578
05/31/2020,0,573,4,0,2,579
06/30/2020,0,572,4,1,1,578
07/31/2020,0,578,1,0,1,580
08/31/2020,0,580,0,0,1,581
09/30/2020,1,576,2,0,1,580
10/31/2020,0,564,13,0,3,580
11/30/2020,2,572,0,1,2,577
12/31/2020,0,571,1,0,2,574
01/31/2021,3,555,12,0,2,572
02/28/2021,0,568,1,0,1,570
03/31/2021,0,553,15,0,2,570
04/30/2021,1,566,1,1,3,572
05/31/2021,2,564,2,0,2,570
06/30/2021,0,565,1,0,2,568
07/31/2021,1,564,1,0,2,568
08/31/2021,0,562,1,0,4,567
09/30/2021,1,558,3,0,2,564
