Up/Down,Upgrade,Same,Downgrade,Defaulted,Non-Rated,Totals
03/31/1981,2,203,19,0,2,226
06/30/1981,7,213,7,0,3,230
09/30/1981,2,222,5,0,2,231
12/31/1981,1,230,4,0,0,235
03/31/1982,2,230,3,2,3,240
06/30/1982,1,227,3,2,3,236
09/30/1982,0,225,5,0,2,232
12/31/1982,3,214,6,0,10,233
03/31/1983,1,226,6,0,5,238
06/30/1983,4,226,4,2,5,241
09/30/1983,3,228,3,1,2,237
12/31/1983,3,230,1,0,4,238
03/31/1984,1,234,2,1,2,240
06/30/1984,7,226,3,0,6,242
09/30/1984,2,235,2,0,3,242
12/31/1984,3,237,4,0,4,248
03/31/1985,0,242,5,2,6,255
06/30/1985,3,249,6,0,5,263
09/30/1985,1,265,6,0,1,273
12/31/1985,3,266,9,1,4,283
03/31/1986,0,268,11,1,9,289
06/30/1986,4,268,4,0,9,285
09/30/1986,5,265,11,0,5,286
12/31/1986,3,277,8,0,8,296
03/31/1987,1,293,1,0,10,305
06/30/1987,1,294,5,1,13,314
09/30/1987,3,303,5,1,6,318
12/31/1987,1,307,4,1,13,326
03/31/1988,6,294,3,3,9,315
06/30/1988,0,287,12,2,9,310
09/30/1988,3,295,7,1,2,308
12/31/1988,1,297,13,0,9,320
03/31/1989,4,303,6,0,5,318
06/30/1989,1,301,0,1,14,317
09/30/1989,4,302,2,1,7,316
12/31/1989,5,296,5,2,10,318
03/31/1990,3,285,8,3,10,309
06/30/1990,2,284,5,3,4,298
09/30/1990,6,267,6,5,11,295
12/31/1990,1,269,5,4,4,283
03/31/1991,3,264,4,7,1,279
06/30/1991,2,265,2,4,4,277
09/30/1991,3,266,2,2,3,276
12/31/1991,7,262,1,5,1,276
03/31/1992,10,259,2,2,2,275
06/30/1992,5,270,6,0,5,286
09/30/1992,1,282,2,3,2,290
12/31/1992,3,275,2,3,13,296
03/31/1993,2,275,4,2,5,288
06/30/1993,8,276,2,0,9,295
09/30/1993,4,284,3,0,9,300
12/31/1993,2,287,3,0,21,313
03/31/1994,3,303,1,1,5,313
06/30/1994,1,311,3,0,1,316
09/30/1994,2,312,5,2,3,324
12/31/1994,4,314,6,1,3,328
03/31/1995,3,311,8,2,8,332
06/30/1995,5,313,6,2,5,331
09/30/1995,0,325,5,4,9,343
12/31/1995,6,325,9,4,5,349
03/31/1996,1,329,9,3,7,349
06/30/1996,5,335,4,0,9,353
09/30/1996,2,345,5,1,10,363
12/31/1996,6,351,5,2,3,367
03/31/1997,4,364,6,0,9,383
06/30/1997,10,368,5,1,7,391
09/30/1997,3,379,8,6,7,403
12/31/1997,1,384,10,3,8,406
03/31/1998,10,393,7,6,9,425
06/30/1998,8,419,8,0,4,439
09/30/1998,0,459,3,2,5,469
12/31/1998,3,458,5,4,11,481
03/31/1999,5,437,14,4,11,471
06/30/1999,4,437,10,7,14,472
09/30/1999,2,456,9,2,5,474
12/31/1999,2,458,11,4,9,484
03/31/2000,5,445,22,6,4,482
06/30/2000,2,466,8,8,2,486
09/30/2000,4,466,10,3,5,488
12/31/2000,7,436,21,11,13,488
03/31/2001,1,455,11,10,2,479
06/30/2001,1,452,13,7,4,477
09/30/2001,5,440,19,5,10,479
12/31/2001,1,424,25,7,13,470
03/31/2002,3,432,9,10,3,457
06/30/2002,7,422,13,3,5,450
09/30/2002,2,440,6,3,7,458
12/31/2002,6,426,14,1,10,457
03/31/2003,0,432,15,3,6,456
06/30/2003,3,428,13,6,6,456
09/30/2003,2,427,14,3,9,455
12/31/2003,1,432,16,4,8,461
03/31/2004,2,466,10,3,8,489
06/30/2004,11,481,7,1,6,506
09/30/2004,6,497,5,1,8,517
12/31/2004,2,498,6,3,12,521
03/31/2005,3,495,8,2,7,515
06/30/2005,4,490,11,1,12,518
09/30/2005,6,471,26,1,18,522
12/31/2005,3,499,6,0,8,516
03/31/2006,3,498,10,0,7,518
06/30/2006,6,492,8,1,18,525
09/30/2006,4,496,7,0,9,516
12/31/2006,2,493,11,2,9,517
03/31/2007,3,468,11,0,35,517
06/30/2007,5,471,11,1,8,496
09/30/2007,6,469,17,2,17,511
12/31/2007,5,479,5,0,12,501
03/31/2008,5,474,6,2,7,494
06/30/2008,8,460,11,2,7,488
09/30/2008,3,458,12,2,9,484
12/31/2008,1,444,20,7,10,482
03/31/2009,1,433,19,8,6,467
06/30/2009,6,413,17,9,13,458
09/30/2009,4,424,6,5,0,439
12/31/2009,8,425,3,3,2,441
03/31/2010,9,423,4,2,9,447
06/30/2010,8,428,4,1,9,450
09/30/2010,1,434,2,3,6,446
12/31/2010,4,430,5,3,11,453
03/31/2011,10,417,14,2,14,457
06/30/2011,8,435,11,4,11,469
09/30/2011,5,453,5,1,9,473
12/31/2011,6,466,4,1,5,482
03/31/2012,4,463,7,2,10,486
06/30/2012,7,470,4,2,11,494
09/30/2012,3,487,7,0,7,504
12/31/2012,4,495,5,0,12,516
03/31/2013,0,512,5,1,10,528
06/30/2013,4,524,9,2,8,547
09/30/2013,3,563,3,1,7,577
12/31/2013,11,567,2,0,10,590
03/31/2014,6,583,5,2,9,605
06/30/2014,4,586,9,1,18,618
09/30/2014,8,594,6,3,17,628
12/31/2014,4,617,10,0,14,645
03/31/2015,3,630,3,3,12,651
06/30/2015,6,611,11,2,14,644
09/30/2015,2,612,8,5,16,643
12/31/2015,7,610,8,5,8,638
03/31/2016,4,599,14,1,16,634
06/30/2016,8,600,10,7,6,631
09/30/2016,3,611,4,3,19,640
12/31/2016,3,606,9,1,19,638
03/31/2017,5,606,21,0,9,641
06/30/2017,2,610,13,6,21,652
09/30/2017,5,598,16,4,24,647
12/31/2017,2,615,10,5,6,638
03/31/2018,7,615,15,6,8,651
06/30/2018,5,622,12,4,17,660
09/30/2018,4,641,8,2,15,670
12/31/2018,4,656,13,3,8,684
03/31/2019,7,657,13,5,11,693
06/30/2019,5,664,15,6,9,699
09/30/2019,5,680,12,3,6,706
12/31/2019,2,678,12,9,13,714
03/31/2020,3,647,40,9,13,712
06/30/2020,2,625,43,22,12,704
09/30/2020,7,643,8,14,13,685
12/31/2020,11,647,8,8,11,685
03/31/2021,8,675,5,4,15,707
06/30/2021,18,680,7,3,17,725
09/30/2021,13,704,6,2,21,746
