Up/Down,Upgrade,Same,Downgrade,Defaulted,Non-Rated,Totals
03/31/1981,0,226,9,0,0,235
06/30/1981,0,232,3,0,0,235
09/30/1981,2,232,2,0,0,236
12/31/1981,4,229,3,0,1,237
03/31/1982,0,234,4,0,0,238
06/30/1982,1,234,3,0,0,238
09/30/1982,3,229,4,1,2,239
12/31/1982,1,231,4,0,0,236
03/31/1983,0,232,5,0,0,237
06/30/1983,1,230,8,0,2,241
09/30/1983,6,229,2,0,2,239
12/31/1983,3,230,7,0,0,240
03/31/1984,4,232,4,0,0,240
06/30/1984,6,231,3,0,1,241
09/30/1984,4,233,4,0,0,241
12/31/1984,8,233,5,0,0,246
03/31/1985,9,234,6,0,2,251
06/30/1985,6,232,14,0,1,253
09/30/1985,1,252,0,0,0,253
12/31/1985,3,250,0,0,1,254
03/31/1986,1,246,4,0,5,256
06/30/1986,13,237,5,0,1,256
09/30/1986,2,253,3,0,2,260
12/31/1986,1,245,13,0,1,260
03/31/1987,5,251,4,0,1,261
06/30/1987,6,246,8,1,3,264
09/30/1987,3,252,6,0,2,263
12/31/1987,0,259,4,0,0,263
03/31/1988,2,257,3,1,6,269
06/30/1988,1,259,4,0,2,266
09/30/1988,5,254,4,1,2,266
12/31/1988,2,259,2,0,0,263
03/31/1989,4,251,7,0,1,263
06/30/1989,5,254,4,0,2,265
09/30/1989,5,254,2,0,2,263
12/31/1989,0,256,6,0,1,263
03/31/1990,1,260,2,0,0,263
06/30/1990,6,254,1,0,4,265
09/30/1990,8,253,1,0,1,263
12/31/1990,8,244,8,0,4,264
03/31/1991,1,262,2,0,0,265
06/30/1991,2,260,2,0,2,266
09/30/1991,1,261,1,2,1,266
12/31/1991,3,260,3,1,0,267
03/31/1992,2,262,8,2,0,274
06/30/1992,3,270,6,1,0,280
09/30/1992,1,278,2,0,2,283
12/31/1992,2,279,1,0,2,284
03/31/1993,0,285,6,0,0,291
06/30/1993,2,292,2,0,0,296
09/30/1993,1,292,3,0,3,299
12/31/1993,0,287,6,0,6,299
03/31/1994,3,288,4,0,3,298
06/30/1994,1,294,3,0,4,302
09/30/1994,0,301,2,0,1,304
12/31/1994,1,301,3,0,2,307
03/31/1995,2,306,2,0,0,310
06/30/1995,2,308,2,0,1,313
09/30/1995,6,304,2,0,4,316
12/31/1995,3,312,1,0,3,319
03/31/1996,1,315,5,0,2,323
06/30/1996,2,322,2,0,2,328
09/30/1996,5,328,3,0,0,336
12/31/1996,0,341,0,0,0,341
03/31/1997,1,343,3,0,2,349
06/30/1997,4,341,9,0,2,356
09/30/1997,2,356,2,0,4,364
12/31/1997,2,366,4,0,0,372
03/31/1998,4,383,4,0,2,393
06/30/1998,2,402,1,0,3,408
09/30/1998,2,412,5,0,0,419
12/31/1998,1,419,9,0,4,433
03/31/1999,9,429,2,1,4,445
06/30/1999,8,436,3,0,7,454
09/30/1999,6,438,7,0,7,458
12/31/1999,6,450,7,0,3,466
03/31/2000,3,451,18,0,2,474
06/30/2000,6,468,9,1,2,486
09/30/2000,3,480,5,1,4,493
12/31/2000,3,469,20,0,4,496
03/31/2001,0,484,17,2,5,508
06/30/2001,3,501,5,0,9,518
09/30/2001,11,502,13,0,4,530
12/31/2001,6,486,32,1,4,529
03/31/2002,2,511,13,14,9,549
06/30/2002,3,493,38,1,3,538
09/30/2002,8,484,34,4,11,541
12/31/2002,7,474,44,2,7,534
03/31/2003,3,500,19,3,7,532
06/30/2003,4,494,25,2,5,530
09/30/2003,1,509,10,4,7,531
12/31/2003,5,502,18,0,5,530
03/31/2004,6,519,3,1,5,534
06/30/2004,0,529,1,0,6,536
09/30/2004,3,526,3,0,7,539
12/31/2004,4,527,6,0,2,539
03/31/2005,3,536,5,0,4,548
06/30/2005,5,527,13,0,5,550
09/30/2005,1,535,2,1,9,548
12/31/2005,1,517,16,1,11,546
03/31/2006,5,532,2,0,6,545
06/30/2006,6,523,3,0,8,540
09/30/2006,6,529,2,0,6,543
12/31/2006,6,526,0,0,6,538
03/31/2007,11,524,4,0,7,546
06/30/2007,16,511,6,0,12,545
09/30/2007,4,532,0,0,10,546
12/31/2007,10,522,2,0,4,538
03/31/2008,5,525,4,0,5,539
06/30/2008,3,525,4,0,4,536
09/30/2008,10,521,2,0,3,536
12/31/2008,1,535,8,0,8,552
03/31/2009,2,524,17,0,3,546
06/30/2009,7,511,16,0,14,548
09/30/2009,2,516,8,0,13,539
12/31/2009,4,516,4,1,2,527
03/31/2010,0,523,8,0,4,535
06/30/2010,7,527,3,1,3,541
09/30/2010,5,530,1,1,4,541
12/31/2010,1,528,10,0,5,544
03/31/2011,2,534,7,0,5,548
06/30/2011,3,536,5,1,3,548
09/30/2011,4,543,3,0,4,554
12/31/2011,3,536,11,0,1,551
03/31/2012,4,525,17,1,7,554
06/30/2012,10,518,19,1,1,549
09/30/2012,1,537,10,0,6,554
12/31/2012,1,538,8,4,1,552
03/31/2013,6,542,1,1,5,555
06/30/2013,7,542,6,0,3,558
09/30/2013,5,551,4,0,2,562
12/31/2013,12,543,8,0,5,568
03/31/2014,0,568,3,0,1,572
06/30/2014,4,566,4,2,0,576
09/30/2014,4,570,3,0,3,580
12/31/2014,2,579,5,0,4,590
03/31/2015,0,587,7,0,3,597
06/30/2015,19,569,6,0,6,600
09/30/2015,2,583,10,0,9,604
12/31/2015,13,581,6,0,4,604
03/31/2016,11,580,9,0,7,607
06/30/2016,13,582,6,0,4,605
09/30/2016,9,576,7,1,12,605
12/31/2016,2,587,6,2,5,602
03/31/2017,6,589,1,0,10,606
06/30/2017,8,580,6,0,7,601
09/30/2017,6,591,6,0,3,606
12/31/2017,4,599,1,1,1,606
03/31/2018,10,585,4,0,10,609
06/30/2018,6,584,5,2,4,601
09/30/2018,10,582,4,0,5,601
12/31/2018,1,582,12,0,7,602
03/31/2019,5,568,11,2,11,597
06/30/2019,1,581,1,0,7,590
09/30/2019,5,572,1,0,8,586
12/31/2019,9,564,4,0,4,581
03/31/2020,2,564,8,1,6,581
06/30/2020,0,562,12,1,3,578
09/30/2020,1,573,3,0,3,580
12/31/2020,2,557,13,1,7,580
03/31/2021,3,536,28,0,5,572
06/30/2021,3,557,4,1,7,572
09/30/2021,2,554,4,0,8,568
