Up/Down,Upgrade,Same,Downgrade,Defaulted,Non-Rated,Totals
03/31/1981,3,89,1,1,0,94
06/30/1981,2,91,1,0,0,94
09/30/1981,1,92,2,0,0,95
12/31/1981,0,92,2,1,0,95
03/31/1982,0,94,0,0,0,94
06/30/1982,2,86,2,2,2,94
09/30/1982,0,87,5,0,0,92
12/31/1982,1,93,1,0,0,95
03/31/1983,1,93,2,0,0,96
06/30/1983,2,94,1,0,2,99
09/30/1983,5,92,1,1,0,99
12/31/1983,1,98,0,0,1,100
03/31/1984,0,96,1,0,2,99
06/30/1984,3,92,1,1,0,97
09/30/1984,5,90,1,1,0,97
12/31/1984,0,93,1,1,1,96
03/31/1985,5,87,1,0,3,96
06/30/1985,1,99,2,0,0,102
09/30/1985,2,102,0,0,1,105
12/31/1985,1,106,0,0,1,108
03/31/1986,1,108,1,0,2,112
06/30/1986,0,109,4,0,1,114
09/30/1986,0,112,2,1,2,117
12/31/1986,0,115,3,0,0,118
03/31/1987,1,112,4,0,2,119
06/30/1987,0,114,1,0,2,117
09/30/1987,1,115,1,0,1,118
12/31/1987,1,114,2,0,3,120
03/31/1988,0,111,4,0,3,118
06/30/1988,1,104,10,0,1,116
09/30/1988,1,112,1,0,3,117
12/31/1988,1,101,11,0,2,115
03/31/1989,2,105,4,1,2,114
06/30/1989,3,97,7,0,5,112
09/30/1989,2,99,4,1,1,107
12/31/1989,2,101,2,0,5,110
03/31/1990,0,98,1,2,5,106
06/30/1990,0,85,10,1,3,99
09/30/1990,0,95,0,0,0,95
12/31/1990,2,90,1,1,1,95
03/31/1991,0,78,11,3,1,93
06/30/1991,0,88,1,3,0,92
09/30/1991,1,89,1,0,0,91
12/31/1991,0,88,3,0,1,92
03/31/1992,2,90,1,0,0,93
06/30/1992,0,92,1,0,1,94
09/30/1992,1,90,2,0,0,93
12/31/1992,0,92,6,0,0,98
03/31/1993,1,91,7,0,1,100
06/30/1993,3,94,0,0,3,100
09/30/1993,6,94,2,0,2,104
12/31/1993,3,101,1,0,3,108
03/31/1994,0,111,1,1,2,115
06/30/1994,1,112,0,0,0,113
09/30/1994,0,113,1,0,2,116
12/31/1994,1,113,0,1,2,117
03/31/1995,2,113,1,1,0,117
06/30/1995,0,114,1,0,2,117
09/30/1995,0,109,4,0,5,118
12/31/1995,1,108,2,2,2,115
03/31/1996,0,114,1,0,0,115
06/30/1996,4,111,1,0,3,119
09/30/1996,3,111,4,0,2,120
12/31/1996,0,119,1,0,1,121
03/31/1997,0,118,1,0,4,123
06/30/1997,3,109,7,0,2,121
09/30/1997,3,116,0,0,6,125
12/31/1997,3,126,2,0,1,132
03/31/1998,0,134,0,0,3,137
06/30/1998,0,135,3,1,3,142
09/30/1998,0,141,4,0,4,149
12/31/1998,0,142,2,1,5,150
03/31/1999,1,138,3,3,0,145
06/30/1999,1,136,6,2,2,147
09/30/1999,1,139,3,2,0,145
12/31/1999,1,140,1,1,1,144
03/31/2000,1,134,5,3,1,144
06/30/2000,3,128,6,3,3,143
09/30/2000,0,133,3,1,2,139
12/31/2000,1,133,3,1,1,139
03/31/2001,3,131,2,2,2,140
06/30/2001,1,137,1,1,0,140
09/30/2001,1,131,6,1,2,141
12/31/2001,1,132,5,2,1,141
03/31/2002,1,134,4,2,2,143
06/30/2002,2,133,4,3,2,144
09/30/2002,1,136,2,1,4,144
12/31/2002,0,132,3,3,2,140
03/31/2003,1,125,7,2,1,136
06/30/2003,1,138,1,2,0,142
09/30/2003,1,140,4,0,2,147
12/31/2003,1,143,2,0,3,149
03/31/2004,0,162,1,0,6,169
06/30/2004,0,163,3,0,1,167
09/30/2004,0,166,3,1,1,171
12/31/2004,2,165,3,1,1,172
03/31/2005,1,173,1,1,2,178
06/30/2005,4,171,4,0,0,179
09/30/2005,2,169,2,3,4,180
12/31/2005,6,163,4,1,2,176
03/31/2006,3,170,3,0,1,177
06/30/2006,0,173,5,0,1,179
09/30/2006,0,178,3,0,0,181
12/31/2006,1,178,2,1,4,186
03/31/2007,3,173,1,0,9,186
06/30/2007,6,172,1,0,2,181
09/30/2007,0,184,3,0,3,190
12/31/2007,1,182,6,0,3,192
03/31/2008,0,186,4,0,3,193
06/30/2008,1,181,6,1,2,191
09/30/2008,0,179,5,2,4,190
12/31/2008,0,165,10,1,10,186
03/31/2009,1,165,6,1,3,176
06/30/2009,0,147,8,1,17,173
09/30/2009,1,154,3,2,0,160
12/31/2009,4,146,6,2,2,160
03/31/2010,2,152,2,1,3,160
06/30/2010,2,155,5,0,1,163
09/30/2010,3,162,0,1,2,168
12/31/2010,6,163,1,0,1,171
03/31/2011,0,170,4,0,1,175
06/30/2011,3,175,3,0,0,181
09/30/2011,3,174,3,3,5,188
12/31/2011,0,177,3,4,1,185
03/31/2012,1,170,5,3,2,181
06/30/2012,5,164,5,1,3,178
09/30/2012,0,172,6,1,3,182
12/31/2012,0,175,5,1,3,184
03/31/2013,4,171,2,1,4,182
06/30/2013,1,174,1,2,4,182
09/30/2013,2,187,1,0,1,191
12/31/2013,2,187,3,1,5,198
03/31/2014,1,192,5,1,3,202
06/30/2014,3,196,5,0,3,207
09/30/2014,0,202,0,0,6,208
12/31/2014,1,206,0,0,2,209
03/31/2015,2,208,2,0,1,213
06/30/2015,6,206,2,3,5,222
09/30/2015,1,212,4,0,7,224
12/31/2015,5,209,2,0,5,221
03/31/2016,4,209,5,1,2,221
06/30/2016,1,210,5,1,4,221
09/30/2016,2,210,4,3,3,222
12/31/2016,3,210,5,2,0,220
03/31/2017,0,219,0,1,1,221
06/30/2017,1,216,4,0,3,224
09/30/2017,2,218,5,0,4,229
12/31/2017,3,224,1,0,2,230
03/31/2018,4,222,4,1,5,236
06/30/2018,3,220,2,1,6,232
09/30/2018,2,225,2,0,2,231
12/31/2018,2,223,4,0,5,234
03/31/2019,0,229,1,1,2,233
06/30/2019,2,222,2,0,5,231
09/30/2019,2,223,1,1,2,229
12/31/2019,1,224,5,0,1,231
03/31/2020,0,215,15,2,4,236
06/30/2020,0,206,20,5,3,234
09/30/2020,2,208,14,2,2,228
12/31/2020,1,217,4,3,3,228
03/31/2021,6,209,3,2,4,224
06/30/2021,5,208,5,2,2,222
09/30/2021,3,220,1,0,4,228
